заголовок: Заголовок
олег: Олег
данильченко: Данильченко
имперский: Имперский
вояж: вояж
читать: читать
онлайн: онлайн
бесплатно: бесплатно
адрес: Адрес
здесь: Здесь
быть: будем
возможность: возможности
весь: весь
текст: текст
электронный: электронной
книга: книге
совершенно: совершенно
целиком: целиком
полный: полная
версия: версию
в: в
некоторый: некоторых
случай: случае
присутствовать: присутствует
краткий: краткое
содержание: содержание
город: Город
м: М
спб: СПб
год: года
выпуск: выпуска
издательство: издательство
аста: АСТ
издательский: Издательский
дом: дом
ленинград: Ленинград
категория: категорию
боевой: Боевая
фантастика: фантастика
космический: Космическая
на: на
русский: русском
язык: языке
описание: описание
произведение: произведении
предисловие: предисловие
а: а
так: так
же: же
отзыв: отзывы
посетитель: посетителей
доступный: доступна
портал: портале
библиотека: Библиотека
либ: Либ
кат: Кат
создать: Создай
для: для
любитель: любителей
полистать: полистать
хороший: лучшими
книжка: книжку
и: и
предлагать: Предлагаем
широкий: широкий
выбор: выбора
жанр: жанров
любовный: любовные
роман: романы
фэнтези: фэнтези
приключение: приключения
детектив: детективы
триллер: триллеры
эротика: эротика
документальный: документальные
научный: научные
юмористический: юмористические
анекдот: анекдоты
о: о
бизнес: бизнесе
проза: проза
детский: детские
сказка: сказки
религиия: религиии
новинка: новинки
православный: православные
старинный: старинные
про: про
компьютер: компьютер
программирование: программирование
английский: английском
домоводство: домоводство
поэзия: поэзия
выбрав: Выбрав
по: по
душа: душе
вы: Вы
смочь: сможешь
найти: нашли
действительно: действительно
стоить: стоящие
насладиться: насладиться
погружение: погружением
мир: мир
воображение: воображения
прочувствовать: прочувствовать
переживание: переживания
герой: героях
или: или
узнать: Узнайте
себя: себя
чтото: чтото
новый: новые
совершить: совершить
внутренний: внутреннее
открытие: открытие
подробный: Подробная
информация: информацию
ознакомление: ознакомления
текущий: текущему
запрос: запросу
представить: представлен
низкий: Ниже
к: к
чтение: чтение
аннотация: аннотацию
зависеть: зависит
от: от
тот: того
что: что
написать: напишите
сам: сами
автор: автора
если: Если
не: не
необходимый: необходимо
комментарий: комментарии
мы: Мы
постараться: постараться
отыскать: отыскать
она: она
кто: Кто
фамилия: фамилию
как: Как
звать: зовут
список: списком
его: его
серия: сериям
уважаемые: Уважаемые
правообладатель: правообладатели
размещать: размещать
наш: нашим
сайт: сайте
у: у
любой: любом
зарегистрировать: зарегистрированного
пользователь: пользователя
ваш: ваши
опубликовать: опубликована
без: без
согласие: согласия
пожалуйста: пожалуйста
направить: направьте
жалоба: жалобу
заполните: заполните
форма: форму
обратный: обратной
связь: связи
течение: течение
час: часов
закрыть: закроем
доступ: доступ
нелегально: нелегально
разместить: размещенному
контент: контенту
разбить: разбитый
страница: страницу
система: Система
сохранение: сохранения
место: места
последний: последней
прочитать: прочитанные
позволять: позволяет
с: с
удобство: удобством
необходимость: необходимости
каждый: каждый
раз: раз
заново: заново
искать: искать
остановиться: остановились
поставить: поставь
закладка: Закладка
момент: момент
перейти: перейти
который: который
закончить: закончили
шрифт: Шрифт
интервал: Интервал
естественно: Естественно
тогда: тогда
прийтись: придтся
сползти: сползти
кровать: кровати
принять: принял
вертикальный: вертикальное
положение: положение
илюха: Илюхе
недовольный: недовольно
слеза: слез
удобный: удобной
шконка: шконки
теперь: Теперь
взять: взять
оружие: оружия
рука: руку
изготовиться: изготовься
стрельба: стрельбы
он: его
послушно: послушно
выполнить: выполнена
требоваться: требовалось
какой: какие
образ: образом
изобразить: изобразить
количество: количество
боеприпас: боеприпас
заряд: заряд
батарея: Батарею
цифровой: Цифровом
процент: процентов
вид: виде
убывать: убывающую
шкала: шкалу
давать: Давай
поверх: поверх
синий: синим
ну: Ну
пусть: пусть
зеленый: зелным
например: например
готовый: готовы
прицелиться: прицелиться
куданибудь: куданибудь
желание: желанию
это: Это
еще: ещ
зачем: зачем
нужный: нужно
настроить: настроить
прицельный: прицельную
сетка: сетку
ты: тобой
я: Я
совместить: совмещу
перекрестие: перекрестье
прицел: прицелом
стрелять: стрелять
навскидку: навскидку
бой: бою
сэкономить: сэкономит
время: время
настольный: настольный
почему: почему
именно: Именно
нравиться: нравится
чегоооо: Чегоооо
замереть: замер
открыть: открытым
рот: ртом
шутка: Шутка
анализ: Анализ
поведение: поведения
энди: Энди
показывать: показывает
мочь: может
ответить: ответить
фуууф: Фуууф
предупреждать: предупреждаю
надо: надо
отслеживать: отслеживать
через: через
инфосеть: инфосеть
использовать: используя
программа: программе
навигатор: навигатор
точно: точно
рассчитать: рассчитать
расстояние: расстояние
до: до
впоследствии: впоследствии
потребоваться: потребуется
корректировка: корректировки
упреждение: упреждения
двигаться: двигающимся
мишень: мишеням
встроить: встроенного
радар: радара
иметь: иметь
приходиться: приходится
цель: цель
идентификатор: идентификаторам
кибернетический: кибернетических
устройство: устройств
нейросеть: Нейросети
тоже: тоже
отследить: отследить
обычный: Обычные
запросто: запросто
модель: модели
сеть: сетей
пока: пока
считаться: считаются
защита: защиту
подобный: подобного
но: Но
вероятность: вероятностью
восемьдесят: восемьдесят
они: ими
переживать: переживай
босс: босс
попадание: попадание
гарантировать: гарантирую
ух: Ух
мой: Мои
лапа: лапа
восхититься: восхитился
илья: Илья
только: только
начало: начало
кокетливый: кокетливо
проворковать: проворковала
ди: Ди
настройка: Настройка
завершить: завершена
позволить: Позволю
напомнить: напомнить
общий: общие
база: базы
знание: знаний
успешно: успешно
спроецировать: спроецированы
отвечать: отвечающие
за: за
память: память
участок: участки
мозг: мозга
пользоваться: пользоваться
свой: своими
проявиться: проявятся
мера: мере
надобность: надобности
информационный: информационные
носитель: носители
прием: Прим
перестройка: Перестройка
организм: организма
под: под
физический: физические
пятнадцать: пятнадцать
окончание: окончание
запланировать: запланировал
месяц: месяц
рекомендовать: Рекомендую
обильный: обильное
питание: питание
растолстеть: Растолстеть
грозить: грозит
позаботиться: позабочусь
какойлибо: какиелибо
пожелание: пожелания
да: да
собирать: собирай
состояние: состоянии
отправлять: отправляй
няга: Нягу
разбудить: разбуди
завтра: завтра
когда: когда
там: там
построение: построение
восемь: восемь
утро: утро
вот: вот
действовать: действуй
остальной: остальное
спать: спал
спокойный: Спокойной
ночь: ночи
спасибо: Спасибо
пробормотать: пробормотал
засыпать: засыпая
гдето: гдето
край: краю
сознание: сознания
услышать: услышал
едва: едва
уловимый: уловимый
ответ: ответ
всегда: Всегда
глава: Глава
начаться: началось
будильник: будильник
похожий: похожие
привычный: привычный
нудный: нудный
звонок: звонок
земной: земного
аналог: аналога
просто: просто
проснуться: проснулся
сразу: сразу
бодрый: бодрым
будто: будто
уже: уже
давно: давно
быстро: Быстро
душ: душ
отправиться: отправился
столовая: столовую
добрый: Доброе
спаться: спалось
кашлять: кашлять
смелость: смелость
влезть: влезла
каталог: каталоги
учебный: учебного
центр: центра
предоставить: предоставить
предложить: предложить
перечень: перечень
получить: получить
первый: первую
очередь: очередь
прекрасный: прекрасно
собственный: собственные
секретарша: секретаршу
голова: голове
здорово: здорово
сказать: Скажи
клясться: клялся
при: при
создание: создании
придать: придал
конфигурация: конфигурацию
пилот: Пилот
муэлита: МУЭлит
значить: значит
кроме: кроме
профиль: профиля
пилот: пилота
должный: должна
технический: технического
верно: Верно
обработка: обработка
уровень: уровне
седьмой: седьмого
поколение: поколения
вообще: Вообще
чудной: чудно
обучение: обучения
исходить: исходя
из: из
осваивать: осваивать
два: два
профессия: профессии
максимально: максимально
забыть: забудь
туда: туда
включить: включить
подготовка: подготовки
десантник: десантников
абордажный: абордажных
команда: команд
выяснить: выяснить
согласно: согласно
договоренность: договоренностям
выполнять: Выполняю
график: график
получиться: получится
очень: очень
плотный: плотным
обычно: обычно
усваивать: усваивают
три: три
ж: ж
придется: придтся
сколько: сколько
успеть: успеем
столько: столько
вынести: вынести
отсюда: отсюда
максимум: максимум
можно: можно
халява: халяву
тихий: тихой
сапа: сапой
добить: добьм
согласный: Согласна
слежение: слежение
этот: этого
гаденыш: гадныша
пилс: Пилса
какойнибудь: какуюнибудь
пакость: пакость
устроить: устроить
поэтому: поэтому
мониторить: мониторить
где: где
представлять: Представляем
внимание: вниманию
отобрать: отобрали
схожий: схожую
название: названию
смысл: смысле
литература: литературу
надежда: надежде
читатель: читателей
больше: больше
вариант: вариантов
интересный: интересные
обсуждение: Обсуждение
мнение: мнения
оставить: Оставьте
думать: думаете
главный: главных
указать: Укажите
конкретно: конкретно
понравиться: понравилось
нет: нет
считать: считаете
