заголовок: Заголовок
олег: Олег
данильченко: Данильченко
имперский: Имперский
вояж: вояж
читать: читать
онлайн: онлайн
бесплатно: бесплатно
адрес: Адрес
здесь: Здесь
быть: будем
возможность: Возможность
весь: вс
текст: текст
электронный: электронной
книга: книге
совершенно: совершенно
целиком: целиком
полный: полную
версия: версию
в: в
некоторый: некоторых
случай: случаях
присутствовать: присутствует
краткий: краткое
содержание: содержание
город: Город
м: М
спб: СПб
год: год
выпуск: выпуска
издательство: издательство
аста: АСТ
издательский: Издательский
дом: дом
ленинград: Ленинград
категория: категорию
боевой: боевого
фантастика: фантастика
космический: Космическая
на: на
русский: русском
язык: язык
описание: описание
произведение: произведении
предисловие: предисловие
а: а
так: так
же: же
отзыв: отзывы
посетитель: посетителей
доступный: доступны
портал: портале
библиотека: Библиотека
либ: Либ
кат: Кат
создать: создана
для: для
любитель: любителей
полистать: полистать
хороший: хорошо
книжка: книжку
и: и
предлагать: Предлагаем
широкий: широкий
выбор: выбора
жанр: жанров
любовный: любовные
роман: романы
фэнтези: фэнтези
приключение: приключения
детектив: детективы
триллер: триллеры
эротика: эротика
документальный: документальные
научный: научные
юмористический: юмористические
анекдот: анекдоты
о: о
бизнес: бизнесе
проза: проза
детский: детские
сказка: сказки
религиия: религиии
новинка: новинки
православный: православные
старинный: старинные
про: про
компьютер: компьютеры
программирование: программирование
английский: английском
домоводство: домоводство
поэзия: поэзия
выбрав: Выбрав
по: по
душа: душе
вы: Вы
смочь: сможете
найти: найти
действительно: действительно
стоить: стоит
насладиться: насладиться
погружение: погружением
мир: мир
воображение: воображения
прочувствовать: прочувствовать
переживание: переживания
герой: героях
или: или
узнать: Узнайте
себя: себя
чтото: чтото
новый: новые
совершить: совершить
внутренний: внутреннее
открытие: открытие
подробный: Подробная
информация: информацию
ознакомление: ознакомления
текущий: текущему
запрос: запросу
представить: представлен
низкий: Ниже
к: к
чтение: чтение
аннотация: аннотацию
зависеть: зависит
от: от
тот: то
что: что
написать: напишите
сам: сам
автор: автора
если: Если
не: не
необходимый: необходимую
комментарий: комментарии
мы: Мы
постараться: постараемся
отыскать: отыскать
она: е
кто: кто
фамилия: фамилию
как: Как
звать: звали
список: списком
его: его
серия: сериям
уважаемые: Уважаемые
правообладатель: правообладатели
размещать: размещать
наш: наша
сайт: сайте
у: У
любой: любой
зарегистрировать: зарегистрированного
пользователь: пользователя
ваш: ваши
опубликовать: опубликована
без: без
согласие: согласия
пожалуйста: пожалуйста
направить: направьте
жалоба: жалобу
заполните: заполните
форма: форму
обратный: обратной
связь: связи
течение: течение
час: часов
закрыть: закроем
доступ: доступ
нелегально: нелегально
разместить: размещенному
контент: контенту
разбить: разбитый
страница: страницу
система: Система
сохранение: сохранения
место: места
последний: последней
прочитать: прочитанные
позволять: позволяет
с: с
удобство: удобством
необходимость: необходимости
каждый: каждый
раз: раз
заново: заново
искать: искать
остановиться: остановились
поставить: Поставьте
закладка: Закладка
момент: моментах
перейти: перейти
который: которые
закончить: закончили
шрифт: Шрифт
интервал: Интервал
делать: Делай
считать: считаете
нужный: Нужно
оба: обоих
уж: уж
ты: тебя
взяться: взялась
личный: личным
секретарь: секретарем
то: то
впредь: впредь
спрашивать: спрашивай
всякий: всяких
дурацкий: дурацких
разрешение: разрешений
разве: разве
только: Только
какойто: какойто
спорный: спорных
теперь: теперь
один: одно
целое: целое
я: я
выгодный: выгодно
приоритет: приоритете
сказать: Сказать
босс: босс
вот: вот
начаться: началось
обучение: обучение
както: Както
буднично: буднично
рутинно: рутинно
короткий: коротким
перерыв: перерывом
обед: обед
до: до
вечер: вечеру
первый: первый
день: дня
голова: головой
раскалываться: раскалывалась
жутко: жутко
хотеться: хотелось
есть: есть
когда: Когда
илья: Илья
выбраться: выбрался
из: из
капсула: капсулы
оказаться: оказалось
кроме: кроме
он: его
тут: тут
уже: уже
никто: никто
нет: нет
прийтись: Пришлось
шагать: шагать
столовая: столовую
одиночка: одиночку
норк: Норк
там: там
удивление: удивлению
илюха: Илюха
за: за
они: них
стол: столом
сидеть: сидели
девчонка: девчонки
попасть: попали
их: их
группа: группа
знакомиться: знакомиться
это: это
два: две
миловидные: миловидные
миниатюрный: миниатюрные
близняшка: близняшки
серьезный: серьезная
рослый: рослая
девушка: девушкам
уступать: уступающая
рост: ростом
землянин: землянин
близнец: Близнецов
милла: Милла
рилла: Рилла
энци: Энци
улыбчивый: Улыбчивые
общительный: общительные
блондинка: блондинки
крупный: Крупная
назваться: назвалась
беррана: Беррана
дегар: Дегар
знать: знаешь
взять: взял
роль: роль
посредник: посредника
мой: мой
друг: друг
коллега: коллеги
несчастие: несчастью
лео: Лео
история: историю
пилс: Пилсом
наверно: наверно
содружество: Содружества
точно: точно
еще: ещ
поморщиться: поморщился
ну: Ну
тянуть: тянет
интересный: интересные
подать: подала
голос: голосом
берран: Беррана
романтично: романтично
вздохнуть: вздохнула
томный: томно
да: Да
ладно: ладно
морщиться: морщиться
весело: Весело
улыбнуться: улыбнулся
риго: Риго
узнавать: узнают
особенно: Особенно
этот: этот
вообще: вообще
новость: новости
свежий: свежие
сплетня: сплетни
оказываться: оказываются
сначала: сначала
потом: потом
становиться: становятся
достояние: достоянием
общественность: общественности
наговаривать: наговариваешь
несерьезно: несерьезно
обидеться: обиделся
вовсе: Вовсе
никакой: никакие
сплетница: сплетницы
назвать: назвал
притворный: Притворно
испуганный: испуганным
уйти: ушел
отмаз: отмаз
парень: парень
конечно: Конечно
служба: служба
разведка: разведки
тссссс: тссссс
балабол: Балабол
выдать: Выдала
свой: своими
оценка: оценку
немного: немного
ничуть: ничуть
зато: зато
веселый: веслый
приятный: Приятно
познакомиться: познакомиться
присаживаясь: присаживаясь
почему: почему
обратиться: обратился
норка: Норку
ах: Ах
осклабиться: осклабился
черим: Черим
бал: Балах
среди: среди
наставник: наставников
числиться: числится
аутсайдер: аутсайдерах
капитан: Капитан
недолюбливать: недолюбливает
поэтому: поэтому
давать: давайте
право: прав
выбирать: выбирать
курсант: курсантов
получаться: получается
доставаться: достаются
большой: больше
брать: брать
хотеть: хочет
вроде: вроде
дешевенький: дешвенькими
сетка: сетками
имплантат: имплантатов
интеллект: интеллект
реакция: реакцию
подобный: подобных
штука: штук
естественный: Естественно
такой: таким
вряд: вряд
ли: ли
достигнуть: достигнет
выдающийся: выдающихся
результат: результатов
можно: можно
наказать: наказать
добро: добро
пожаловать: пожаловать
команда: команда
неудачник: неудачники
паясничая: паясничая
развести: развел
рука: руками
понятно: Понятно
кивнуть: кивнул
советовать: советую
девчата: девчата
думать: думаете
ответить: Ответила
заинтересованно: заинтересованно
слушать: слушали
разговор: разговор
взгляд: взгляд
но: но
похоже: похоже
согласный: согласен
пояснить: Пояснишь
точка: точку
зрение: зрения
охотно: Охотно
согласиться: согласился
вопервых: Вопервых
лейтенант: лейтенант
пентюх: пентюх
какой: каким
мочь: Может
показаться: показаться
защитный: защитная
маска: маска
вовторых: Вовторых
сегодня: сегодня
подсказать: подсказал
мысль: мысль
кстати: кстати
тоже: тоже
слышать: слышали
напомнить: Напомню
забыть: забыли
дорогой: дорогой
нейросеть: нейросети
важный: важно
старание: старание
нешаблонный: нешаблонное
мышление: мышление
втретьих: Втретьих
отличие: отличие
остальной: остальных
единственный: единственный
иметь: имеет
реальный: реальный
опыт: опыт
судить: судя
орденский: орденским
плашка: плашкам
солидный: солидный
перед: перед
живой: живой
здоровый: здоровый
говорить: говори
мастерство: мастерстве
пилот: пилота
подход: подход
чтобы: чтобы
поделиться: поделился
знание: знаниями
правда: правде
пробовать: пробовала
смотреть: смотреть
ситуация: ситуацию
под: под
угол: углом
разница: разницу
сеть: сетей
имплант: имплантами
забывать: забывать
бы: бы
стать: стала
просто: просто
учитывать: учитывать
план: план
нахмуриться: Нахмурилась
суслик: суслики
навострив: навострив
розовый: розовые
ушко: ушки
начать: начал
вытягивать: вытягивать
приходиться: приходится
начало: начала
прояснить: проясним
между: между
откинуться: Откинулся
спинка: спинку
стул: стула
действовать: действовать
действуем: действуем
сообща: сообща
учиться: учимся
другой: другое
представлять: Представляем
внимание: вниманию
похожий: похожие
отобрать: отобрали
схожий: схожую
название: названию
смысл: смысле
литература: литературу
надежда: надежде
предоставить: предоставить
читатель: читателей
больше: больше
вариант: вариантов
обсуждение: Обсуждение
собственный: собственные
мнение: мнения
оставить: Оставьте
главный: главных
указать: Укажите
конкретно: конкретно
понравиться: понравилось
