заголовок: Заголовок
олег: Олег
данильченко: Данильченко
имперский: Имперский
вояж: вояж
читать: читать
онлайн: онлайн
бесплатно: бесплатно
адрес: Адрес
здесь: Здесь
быть: был
возможность: Возможность
весь: все
текст: текст
электронный: электронной
книга: книге
совершенно: совершенно
целиком: целиком
полный: полную
версия: версию
в: в
некоторый: некоторых
случай: случае
присутствовать: присутствует
краткий: краткое
содержание: содержание
город: Город
м: М
спб: СПб
год: год
выпуск: выпуска
издательство: издательство
аста: АСТ
издательский: Издательский
дом: дом
ленинград: Ленинград
категория: категорию
боевой: Боевая
фантастика: фантастика
космический: Космическая
на: на
русский: русском
язык: языке
описание: описание
произведение: произведении
предисловие: предисловие
а: а
так: так
же: же
отзыв: отзывы
посетитель: посетителей
доступный: доступны
портал: портале
библиотека: Библиотека
либ: Либ
кат: Кат
создать: создана
для: для
любитель: любителей
полистать: полистать
хороший: хорошим
книжка: книжку
и: и
предлагать: Предлагаем
широкий: широкий
выбор: выбора
жанр: жанров
любовный: любовные
роман: романы
фэнтези: фэнтези
приключение: приключения
детектив: детективы
триллер: триллеры
эротика: эротика
документальный: документальные
научный: научные
юмористический: юмористические
анекдот: анекдоты
о: о
бизнес: бизнесе
проза: проза
детский: детские
сказка: сказки
религиия: религиии
новинка: новинки
православный: православные
старинный: старинные
про: про
компьютер: компьютеры
программирование: программирование
английский: английском
домоводство: домоводство
поэзия: поэзия
выбрав: Выбрав
по: по
душа: душе
вы: Вы
смочь: сможете
найти: нашла
действительно: действительно
стоить: стоящие
насладиться: насладиться
погружение: погружением
мир: мир
воображение: воображения
прочувствовать: прочувствовать
переживание: переживания
герой: героях
или: или
узнать: Узнайте
себя: себе
чтото: чтото
новый: новые
совершить: совершить
внутренний: внутренних
открытие: открытие
подробный: Подробная
информация: информацию
ознакомление: ознакомления
текущий: текущему
запрос: запросу
представить: представлен
низкий: Ниже
к: К
чтение: чтение
аннотация: аннотацию
зависеть: зависит
от: от
тот: тем
что: что
написать: напишите
сам: сама
автор: автора
если: если
не: не
необходимый: необходимую
комментарий: комментарии
мы: Мы
постараться: постараемся
отыскать: отыскать
она: она
кто: Кто
фамилия: фамилию
как: как
звать: зовут
список: списком
его: его
серия: сериям
уважаемые: Уважаемые
правообладатель: правообладатели
размещать: размещать
наш: нашем
сайт: сайте
у: у
любой: любой
зарегистрировать: зарегистрированного
пользователь: пользователя
ваш: ваши
опубликовать: опубликована
без: без
согласие: согласия
пожалуйста: пожалуйста
направить: направьте
жалоба: жалобу
заполните: заполните
форма: форме
обратный: обратной
связь: связи
течение: течение
час: часов
закрыть: закроем
доступ: доступ
нелегально: нелегально
разместить: размещенному
контент: контенту
разбить: разбитый
страница: страницу
система: системы
сохранение: сохранения
место: места
последний: последней
прочитать: прочитанные
позволять: позволяет
с: с
удобство: удобством
необходимость: необходимости
каждый: каждому
раз: раз
заново: заново
искать: искать
остановиться: остановились
поставить: Поставьте
закладка: Закладка
момент: момент
перейти: перейти
который: которого
закончить: закончили
шрифт: Шрифт
интервал: Интервал
успеть: успел
усвоить: усвоить
до: до
окончание: окончания
обучение: обучения
третий: третий
уровень: уровень
база: баз
освоить: освоить
самый: самым
оптимистичный: оптимистичным
прогноз: прогнозам
мочь: может
удаться: удалось
начать: начать
четвертый: четвертый
больший: большие
просто: просто
ну: Ну
прекрасно: прекрасно
главный: главных
максимум: максимум
еще: ещ
закачать: закачать
халява: халяву
там: там
доучить: доучим
согласный: согласен
тогда: Тогда
идти: идем
питаться: питаться
землянин: землянин
войти: войти
помещение: помещение
столовая: столовой
тут: Тут
оказаться: оказался
окружить: окружн
толпа: толпой
за: За
три: три
день: день
он: его
находиться: находился
медкапсула: медкапсуле
следственный: следственного
изолятор: изолятора
оказываться: оказывается
стать: стал
знаменитость: знаменитостью
школа: школе
выясниться: Выяснилось
это: это
время: времени
народ: народ
только: только
делать: делала
обсуждать: обсуждал
бой: бой
инструктор: инструктором
еле: Еле
отбиться: отбиться
нормально: нормально
поесть: поесть
но: но
смыться: смыться
каюта: каюту
дать: дали
ребята: Ребята
команда: команды
глава: главе
беррана: Беррана
демонстративно: демонстративно
запереться: заперлись
оккупировать: оккупировав
свободный: свободные
илюха: Илюха
прийтись: Пришлось
сидеть: сидит
стол: столе
после: После
они: их
ультимативный: ультимативной
потребовать: потребовали
рассказывать: рассказывая
обещать: обещал
теперь: Теперь
отвертеться: отвертишься
заявить: заявила
бер: Бер
говорить: говорил
патсаан: патсаан
сказать: сказать
сделать: сделал
хотеть: хотел
пойти: пойти
куданибудь: куданибудь
посидеть: посидеть
приятный: приятной
обстановка: обстановке
неуклюжий: неуклюжую
попытка: попытку
посиделки: Посиделок
благодаря: благодаря
ты: тебе
благополучно: благополучно
лишиться: лишились
давать: давай
откуда: откуда
короче: короче
свой: свою
история: история
потом: потом
отвечать: отвечать
куча: кучу
вопрос: вопросов
затем: Затем
предложить: предложил
высказаться: высказаться
общий: общем
знакомиться: знакомились
дочь: дочь
отставной: отставного
военный: военные
пилот: пилота
отец: отца
нынче: нынче
заниматься: занимались
промысл: промыслом
горный: горным
сибер: сиберы
этот: этой
животное: Животное
обитать: обитают
планета: планете
пирна: Пирна
сиберы: Сиберы
часть: часть
травоядный: травоядные
млекопитающее: млекопитающие
при: при
побрезгуют: побрезгуют
мелкий: мелкой
живность: живностью
судить: Судя
изображение: изображениям
продемонстрировать: продемонстрировала
отдаленно: отдалнно
похожий: похожие
земной: земных
коза: коз
даже: даже
рог: Рога
иметься: имелось
скрутить: скрученные
спираль: спираль
размер: размером
сибера: сиберы
крупный: крупную
корова: корову
нисколько: нисколько
мешать: мешает
ловко: ловко
скакать: скакать
круча: кручам
очень: очень
осторожный: осторожные
чуткий: чуткие
считаться: Считается
сильный: сильные
эмпатый: эмпаты
поэтому: поэтому
охотник: охотников
сложный: сложно
добыть: добыть
зверь: зверя
чувствовать: чувствует
эмоция: эмоции
причем: причм
расстояние: расстоянии
более: более
километр: километра
предпочитать: предпочитает
унести: унести
нога: ноги
заранее: заранее
становиться: становится
понятный: понятным
почему: почему
такой: такого
ружье: ружь
рс: РС
б: Б
столь: столь
популярный: популярно
среди: среди
иметь: имеют
нежный: нежное
вкусный: вкусное
мясо: мясо
также: также
красивый: красивый
белый: белый
мех: мех
солнце: солнце
отливает: отливает
ультрамарин: ультрамарином
кроме: Кроме
из: из
орган: органы
добываться: добывается
какойто: какойто
жутко: жутко
дорогой: дорогой
препарат: препарат
важный: важный
производство: производства
нейросеть: нейросетей
толком: толком
знать: знает
скупщик: скупщики
разбирать: разбирают
горячий: горячие
пирожок: пирожки
копыто: копыта
тоже: тоже
забываться: забываются
брать: берут
сувенирный: сувенирных
поделка: поделок
слово: слову
девушка: девушки
категорически: категорически
против: против
когда: когда
изъявить: изъявила
желание: желание
стопа: стопам
однако: Однако
коса: коса
камень: камень
упрямство: Упрямства
оба: обоим
занимать: занимать
скандал: Скандал
разгореться: разгорелся
нешуточный: нешуточный
ведь: ведь
видеть: видел
качество: качестве
юрист: юриста
ни: ни
какой: какую
соглашаться: соглашалась
родитель: Родитель
рвать: рвал
метать: метал
неизвестный: неизвестно
бы: бы
кончиться: кончилось
дело: дело
б: б
мама: Мама
хрупкий: хрупкая
миниатюрный: миниатюрная
женщина: женщины
железный: железное
влияние: влияние
муж: мужа
спальня: спальне
умалчивать: умалчивает
разрешение: разрешение
получить: получено
один: одним
условие: условием
никакой: никакой
армия: армии
токм: токма
сугубо: сугубо
гражданский: гражданский
флот: флот
обойти: обошли
мужчина: мужчину
короткий: короче
итог: итоге
честь: честь
учиться: учиться
вместе: вместе
упрямица: упрямицей
риго: Риго
проще: проще
сын: Сын
потомственный: потомственного
шахтер: шахтером
крайне: крайне
редко: редко
батя: Батя
вечно: вечно
пропадать: пропадал
гдето: гдето
окраина: окраине
астероид: астероиды
добывать: добывая
всякий: всякие
полезность: полезности
появляться: Появлялся
дома: дома
два: два
чтобы: чтобы
снова: снова
пропасть: пропасть
месяц: месяцы
жить: Жили
правда: правда
небогато: небогато
принцип: принципе
бедствовать: бедствовали
воспитание: Воспитанием
дед: дед
инженер: инженером
совместительство: совместительству
уже: уже
бывший: бывшим
кстати: Кстати
идея: идея
бросить: бросить
шахтерский: шахтерскую
стезя: стезю
решить: решил
внук: внуку
нет: нет
надобность: надобности
повторять: повторять
судьба: судьбу
пращур: пращуров
норк: Норк
полностью: полностью
тащить: тащить
лямка: лямку
ковыряя: ковыряя
зато: Зато
податься: податься
маман: маман
встать: встала
поза: позу
мол: мол
через: через
ее: е
труп: труп
папахен: Папахен
причина: причинам
дискуссия: дискуссии
участие: участия
принимать: принимал
спорить: спорили
долго: долго
результат: результат
вот: вот
лыбиться: лыбится
счастие: счастье
лицезреть: лицезреть
довольный: довольную
веселый: веслую
рожа: рожу
представлять: Представляем
внимание: вниманию
отобрать: отобрали
схожий: схожую
название: названию
смысл: смысле
литература: литературу
надежда: надежде
предоставить: предоставить
читатель: читателей
больше: больше
вариант: вариантов
интересный: интересные
обсуждение: Обсуждение
собственный: собственные
мнение: мнения
оставить: Оставьте
думать: думаете
указать: Укажите
конкретно: конкретно
понравиться: понравилось
считать: считаете
