заголовок: Заголовок
олег: Олег
данильченко: Данильченко
имперский: Имперский
вояж: вояж
читать: читать
онлайн: онлайн
бесплатно: бесплатно
адрес: Адрес
здесь: Здесь
быть: был
возможность: Возможность
весь: вс
текст: текст
электронный: электронной
книга: книге
совершенно: совершенно
целиком: целиком
полный: полную
версия: версию
в: в
некоторый: некоторых
случай: случаях
присутствовать: присутствует
краткий: краткое
содержание: содержание
город: город
м: М
спб: СПб
год: год
выпуск: выпуска
издательство: издательство
аста: АСТ
издательский: Издательский
дом: дом
ленинград: Ленинград
категория: категорию
боевой: Боевая
фантастика: фантастика
космический: Космическая
на: на
русский: русском
язык: языке
описание: описание
произведение: произведении
предисловие: предисловие
а: а
так: так
же: же
отзыв: отзывы
посетитель: посетителей
доступный: доступны
портал: портале
библиотека: Библиотека
либ: Либ
кат: Кат
создать: созданный
для: для
любитель: любителей
полистать: полистать
хороший: хорошую
книжка: книжку
и: и
предлагать: Предлагаем
широкий: широкий
выбор: выбора
жанр: жанров
любовный: любовные
роман: романы
фэнтези: фэнтези
приключение: приключения
детектив: детективы
триллер: триллеры
эротика: эротика
документальный: документальные
научный: научные
юмористический: юмористические
анекдот: анекдоты
о: о
бизнес: бизнесе
проза: проза
детский: детские
сказка: сказки
религиия: религиии
новинка: новинки
православный: православные
старинный: старинные
про: про
компьютер: компьютеры
программирование: программирование
английский: английском
домоводство: домоводство
поэзия: поэзия
выбрав: Выбрав
по: по
душа: душе
вы: Вы
смочь: сможете
найти: нашли
действительно: действительно
стоить: стоящие
насладиться: насладиться
погружение: погружением
мир: мир
воображение: воображения
прочувствовать: прочувствовать
переживание: переживания
герой: героях
или: или
узнать: Узнайте
себя: себя
чтото: чтото
новый: новые
совершить: совершить
внутренний: внутреннее
открытие: открытие
подробный: Подробная
информация: информацию
ознакомление: ознакомления
текущий: текущему
запрос: запросу
представить: представлен
низкий: Ниже
к: к
чтение: чтение
аннотация: аннотацию
зависеть: зависит
от: от
тот: те
что: что
написать: напишите
сам: самого
автор: автора
если: Если
не: не
необходимый: необходимую
комментарий: комментарии
мы: Мы
постараться: постараемся
отыскать: отыскать
она: она
кто: кому
фамилия: фамилию
как: как
звать: зовут
список: списком
его: его
серия: сериям
уважаемые: Уважаемые
правообладатель: правообладатели
размещать: размещать
наш: нашем
сайт: сайте
у: У
любой: любой
зарегистрировать: зарегистрированного
пользователь: пользователя
ваш: ваши
опубликовать: опубликована
без: без
согласие: согласия
пожалуйста: пожалуйста
направить: направьте
жалоба: жалобу
заполните: заполните
форма: форму
обратный: обратной
связь: связи
течение: течение
час: час
закрыть: закроем
доступ: доступ
нелегально: нелегально
разместить: размещенному
контент: контенту
разбить: разбитый
страница: страницу
система: системы
сохранение: сохранения
место: место
последний: последней
прочитать: прочитанные
позволять: позволяет
с: с
удобство: удобством
необходимость: необходимости
каждый: каждый
раз: раз
заново: заново
искать: искать
остановиться: остановились
поставить: Поставьте
закладка: Закладка
момент: момент
перейти: перейти
который: которого
закончить: закончили
шрифт: Шрифт
интервал: Интервал
следующий: следующий
день: дня
наконец: наконец
прийти: пришло
время: время
отправляться: отправляться
переходный: переходного
шлюз: шлюза
илюха: Илюха
встретить: встретил
грег: Грег
передать: передал
он: он
банковский: банковскую
карта: карту
красивый: красивых
логотип: логотипом
центральный: Центральная
банк: банка
империя: Империи
мало: мало
отличаться: отличается
приходиться: приходилось
видеть: видел
земля: Земле
разве: Разве
только: только
размер: размером
напоследок: Напоследок
шепнуть: шепнул
получить: получил
свой: своим
лоялитипоинт: лоялитипоинт
сразу: сразу
перевести: переведт
оговорить: оговоренную
сумма: сумму
ну: ну
посоветовать: посоветовал
после: после
получение: получения
гражданство: гражданство
тянуть: тянуть
идти: шедший
устанавливать: устанавливать
нейросеть: нейросеть
подмигнуть: подмигнул
добавить: добавил
молодец: Молодец
илио: Илио
еще: ещ
успеть: успел
уже: уже
заполучить: заполучил
один: одной
из: из
самый: самых
гражданка: гражданок
оттянуться: Оттянись
там: там
катушка: катушку
это: этого
заслужить: заслужила
сказаться: сказался
жутко: жутко
занятой: занятым
отбыть: отбыл
ведомый: ведомые
дать: дали
илья: Илья
сумка: сумкой
рука: руке
покоиться: покоились
выбрать: выбранные
девушка: девушкой
наряд: наряды
этот: этих
другой: другой
одеть: одетый
фривольный: фривольное
платьице: платьице
открывать: открывающее
всеобщий: всеобщее
обозрение: обозрение
наверное: наверное
даже: даже
больше: больше
чем: чем
закрывать: закрывающее
отправиться: отправился
доку: доку
челнок: челноков
чтобы: чтобы
сесть: сесть
попутный: попутный
до: до
станция: станции
гео: Гео
джойло: Джойл
парадный: парадный
мундир: мундир
они: их
сопровождать: сопровождал
вертеть: вертел
голова: головой
сторона: стороны
сова: сова
интересный: интересные
жуть: жути
энди: Энди
легкомысленно: легкомысленно
щебетала: щебетала
сзади: сзади
смотреть: смотрел
тоже: тоже
улыбаться: улыбался
мочь: могут
радоваться: радовался
за: За
сестра: сестру
рассмотреть: рассмотреть
удаться: удалось
да: да
тут: тут
рассмотришь: рассмотришь
переходной: Переходной
рукав: рукав
ты: ты
внутри: внутри
земной: земном
пассажирский: пассажирском
самолет: самолете
иметься: имелись
различие: различия
то: то
несущественный: несущественные
иллюминатор: Иллюминаторов
путь: Путь
занять: занял
три: три
ощущение: ощущениям
рассказывать: рассказывая
происходить: происходит
ее: е
слово: словам
нужный: нужно
добраться: добраться
кадар: Кадара
орбита: орбите
находиться: находится
военный: Военная
куда: куда
прибыть: прибыл
непобедимый: Непобедимый
называться: называлась
оплот: Оплот
газовый: газового
гигант: гиганта
приличный: приличном
удаление: удалении
ход: ходом
потребоваться: потребуется
два: два
но: но
сократить: сократить
существовать: Существуют
называть: называйте
разгонный: разгонные
катапульта: катапульты
дело: делам
ничто: ничего
разгонять: разгоняют
сказать: Сказали
аналог: аналог
древний: древних
врата: врат
шаловливый: шаловливыми
ручка: ручками
человек: людей
работать: работают
такой: таких
исключительно: исключительно
короткий: короче
сравнение: сравнению
гиперврата: гипервратами
расстояние: расстояния
ученый: Учные
вплотную: вплотную
подойти: подошли
разгадка: разгадке
устройство: устройства
гиперврата: гиперврат
пока: Пока
понять: понял
откуда: откуда
черпать: черпают
энергия: энергию
создание: создания
постоянный: постоянного
гиперпрокол: гиперпрокола
вернее: Вернее
прекрасно: прекрасно
знать: знает
местный: местного
звезда: звезды
вестимый: вестимо
вот: вот
загадка: загадка
развлекать: развлекала
пояснение: пояснениями
лихо: лихо
надувать: надувал
пузырь: пузыри
мирно: мирно
похрапывать: похрапывая
соседний: соседнем
кресло: кресло
пролететь: пролетело
незаметно: незаметно
предложить: предложил
зайти: зайти
кафешка: кафешку
подкрепиться: подкрепиться
довезти: довезет
орбитальный: орбитального
лифт: лифта
через: через
сделать: сделано
предыдущий: предыдущего
ведь: Ведь
обзорный: обзорная
палуба: палуба
мол: мол
насмотреться: насмотрится
тошнота: тошноты
таки: таки
стать: станет
пилот: пилот
лично: лично
нисколечко: нисколечко
сомневаться: сомневается
попытаться: попытался
возразить: возразить
известный: известно
хватить: хватило
ли: ли
интеллект: интеллекта
ответ: ответ
пусть: пусть
попробовать: попробует
убить: убьт
потом: потом
воскресить: воскресит
зацеловать: зацелует
смерть: смерти
снова: снова
чтонибудь: чтонибудь
придумать: придумают
общий: общем
протащить: протащен
умопомрачительный: умопомрачительным
ураган: ураганом
лицо: лице
подруга: подруги
где: где
плюхнуться: плюхнулся
знакомый: знакомое
рядом: рядом
приземлиться: приземлилась
внутрисистемный: внутрисистемного
предназначить: предназначен
перевозка: перевозки
пассажир: пассажиры
являться: является
кабина: кабиной
пачка: пачкой
гроздь: гроздью
нравиться: нравится
стыковаться: стыкуются
ячейка: ячейками
соответственно: соответственно
опускать: опускает
поверхность: поверхность
планета: планеты
грузовой: грузовыми
платформа: платформами
возить: возят
суд: суд
выйти: Выйдя
улица: улицу
терминал: терминала
сначала: сначала
попасть: попал
ожидать: ожидал
увидеть: увидеть
вместо: вместо
парк: парка
везде: Везде
зелень: зелень
стоять: Стояли
высокий: высокие
дерево: деревьев
похожий: похожие
бук: буки
както: както
германия: Германии
довестись: довелось
побывать: побывать
моторист: мотористом
торговый: торгового
флот: флота
касаться: касается
тень: тени
величественный: величественных
разный: разные
расходиться: расходились
средний: средней
ширина: ширины
дорожка: дорожек
спешить: спешили
усадить: усажен
аэротакси: аэротакси
панель: панели
молниеносно: молниеносно
натыкать: натыкала
видимо: Видимо
ввести: ввела
назначение: назначения
догадаться: догадался
будущий: будущий
небольшой: Небольшой
четырехместный: четырехместный
экипаж: экипаж
плавно: плавно
взмыть: взмыл
вертикально: вертикально
вверх: вверх
устремиться: устремился
кудато: кудато
представлять: Представляем
внимание: вниманию
отобрать: отобрали
схожий: схожую
название: названию
смысл: смысле
литература: литературу
надежда: надежде
предоставить: предоставить
читатель: читателей
вариант: вариантов
обсуждение: Обсуждение
просто: просто
собственный: собственные
мнение: мнения
оставить: Оставьте
думать: думаете
главный: главных
указать: Укажите
конкретно: конкретно
понравиться: понравилось
нет: нет
почему: почему
считать: считаете
