заголовок: Заголовок
олег: Олег
данильченко: Данильченко
имперский: Имперский
вояж: вояж
читать: читать
онлайн: онлайн
бесплатно: бесплатно
адрес: Адрес
здесь: Здесь
быть: был
возможность: возможность
весь: вс
текст: текст
электронный: электронной
книга: книге
совершенно: совершенно
целиком: целиком
полный: полную
версия: версию
в: в
некоторый: некоторых
случай: случаях
присутствовать: присутствовало
краткий: краткое
содержание: содержание
город: Город
м: М
спб: СПб
год: лет
выпуск: выпуска
издательство: издательство
аста: АСТ
издательский: Издательский
дом: дом
ленинград: Ленинград
категория: категорию
боевой: Боевая
фантастика: фантастика
космический: Космическая
на: на
русский: Русский
язык: языком
описание: описание
произведение: произведении
предисловие: предисловие
а: а
так: так
же: же
отзыв: отзывы
посетитель: посетителей
доступный: доступны
портал: портале
библиотека: Библиотека
либ: Либ
кат: Кат
создать: создана
для: для
любитель: любителей
полистать: полистать
хороший: хорошую
книжка: книжку
и: и
предлагать: Предлагаем
широкий: широкий
выбор: выбора
жанр: жанров
любовный: любовные
роман: романы
фэнтези: фэнтези
приключение: приключения
детектив: детективы
триллер: триллеры
эротика: эротика
документальный: документальные
научный: научные
юмористический: юмористические
анекдот: анекдоты
о: о
бизнес: бизнесе
проза: проза
детский: детские
сказка: сказки
религиия: религиии
новинка: новинки
православный: православные
старинный: старинные
про: про
компьютер: компьютеры
программирование: программирование
английский: английском
домоводство: домоводство
поэзия: поэзия
выбрав: Выбрав
по: по
душа: душе
вы: Вы
смочь: сможете
найти: нашли
действительно: действительно
стоить: стоящий
насладиться: насладиться
погружение: погружением
мир: мир
воображение: воображения
прочувствовать: прочувствовать
переживание: переживания
герой: героях
или: или
узнать: Узнайте
себя: себе
чтото: чегото
новый: новые
совершить: совершить
внутренний: внутреннее
открытие: открытие
подробный: Подробная
информация: информацию
ознакомление: ознакомления
текущий: текущему
запрос: запросу
представить: представьте
низкий: низкой
к: К
чтение: чтение
аннотация: аннотацию
зависеть: зависит
от: от
тот: тому
что: что
написать: напишите
сам: Сам
автор: автора
если: если
не: не
необходимый: необходимую
комментарий: комментарии
мы: Мы
постараться: постараемся
отыскать: отыскать
она: е
кто: кто
фамилия: фамилию
как: как
звать: зовут
список: списком
его: его
серия: сериям
уважаемые: Уважаемые
правообладатель: правообладатели
размещать: размещать
наш: нашем
сайт: сайте
у: у
любой: любого
зарегистрировать: зарегистрированного
пользователь: пользователя
ваш: ваши
опубликовать: опубликована
без: без
согласие: согласия
пожалуйста: пожалуйста
направить: направьте
жалоба: жалобу
заполните: заполните
форма: форму
обратный: обратной
связь: связи
течение: течение
час: часов
закрыть: закроем
доступ: доступ
нелегально: нелегально
разместить: размещенному
контент: контенту
разбить: разбитый
страница: страницу
система: Система
сохранение: сохранения
место: места
последний: последнее
прочитать: прочитанные
позволять: позволяет
с: с
удобство: удобством
необходимость: необходимости
каждый: каждый
раз: раз
заново: заново
искать: искать
остановиться: остановились
поставить: Поставьте
закладка: Закладка
момент: момент
перейти: перейти
который: котором
закончить: закончили
шрифт: Шрифт
интервал: Интервал
илья: Илья
пытаться: пытался
спросить: спросил
где: где
он: он
происходить: происходит
ведь: ведь
впервые: впервые
за: за
время: время
оказаться: оказался
общий: общем
там: там
появиться: появилась
задать: задать
вопрос: вопросами
надежда: надежде
получить: получу
ответ: ответы
но: Но
судьба: судьба
сознание: Сознание
толком: толком
восстановиться: восстановившись
вновь: вновь
стать: стало
проваливаться: проваливаться
темнота: темноту
илюха: Илюха
проснуться: проснулся
свежий: свежим
бодрый: бодрым
хорошо: хорошо
уже: уже
давно: давно
чувствовать: чувствовал
осторожно: Осторожно
ради: ради
эксперимент: эксперимента
пошевелить: пошевелил
палец: пальцы
рука: рук
пошевелились: Пошевелились
положенный: положено
послушный: послушным
проделать: Проделал
нога: ног
этот: этот
послушно: послушно
шевелиться: шевелились
однако: Однако
открывать: открывать
глаз: глазами
отчегото: отчегото
боязно: боязно
вспомниться: Вспомнилась
народный: народная
мудрость: мудрость
гласить: гласит
ты: ты
утро: утром
ничто: ничего
болеть: болит
проверить: проверь
возможно: возможно
умереть: умер
человек: человек
привычный: привычен
жить: жить
нормально: Нормально
да: Да
становиться: становится
вдруг: вдруг
совсем: совсем
то: то
ждать: ждт
какойнибудь: какойнибудь
пакость: пакости
обязательный: обязательно
вот: вот
открыть: открыл
трындец: трындец
приятный: приятное
кончиться: кончится
лежать: лежал
удивительно: удивительно
удобный: удобно
свой: своей
состояние: состояние
оценивать: оценивал
банальный: банальной
фраза: фразой
родиться: родился
поэтому: поэтому
хотеться: хотелось
растянуть: растянуть
долгий: подольше
выйти: вышло
молодой: молодой
хватить: хватит
притворяться: притворяться
раздаться: раздался
знакомый: знакомый
голос: голос
теперь: теперь
нотка: нотками
ехидство: ехидства
я: я
знать: знаю
спать: спите
мочь: могу
смело: смело
приводить: приводить
вертикальный: вертикальное
положение: положение
первый: Первое
увидеть: увидел
это: этого
улыбаться: улыбающееся
лицо: лицо
мужчина: мужчина
приблизительно: приблизительно
сорок: сорока
обычный: обычное
наружность: наружности
бровь: Брови
ресница: ресницы
волос: волосы
должный: должны
терпеливо: терпеливо
легкий: лгкой
улыбка: улыбкой
озираться: озирался
сторона: сторонам
подобрать: подобрать
нужный: нужно
слово: слово
весьма: весьма
затруднительный: затруднительно
ну: Ну
яйцо: яйца
только: Только
очень: очень
большой: большого
такой: такое
труд: труда
поместиться: поместиться
пусть: пусть
рост: роста
разрезать: разрезано
вдоль: вдоль
пополам: пополам
один: одного
половина: половины
второй: вторая
поднять: поднятой
приходиться: Приходилось
когданибудь: когданибудь
коробочка: коробочку
обручальный: обручальным
кольцо: кольцом
нет: нет
видеть: вижу
делаться: делается
агрегат: агрегата
раскрыть: раскрыт
точьвточь: точьвточь
внутри: Внутри
видно: видно
множество: множество
всякий: всяких
прибор: приборов
оборудование: оборудования
какойто: Какието
трубочка: трубочки
больший: большие
маленький: маленькие
манипулятор: манипуляторы
захват: захваты
еще: ещ
тьма: тьму
разный: разной
другой: другом
машинерия: машинерии
просто: просто
идентифицировать: идентифицировать
более: более
понять: понять
назначение: назначение
нравиться: нравится
рядом: рядом
чтобы: чтобы
начало: начала
ответить: ответил
также: также
бы: бы
далекий: дальше
когда: когда
сказать: скажите
ли: ли
обвести: обвел
окружать: окружающей
пространство: пространство
почему: почему
понимать: понимаю
говорить: говорить
точно: точно
ранний: раньше
владеть: владел
молодец: молодец
успеть: успели
очнуться: очнуться
завалить: завалили
при: При
особо: особо
удивляться: удивляться
обстановка: обстановке
судить: Судя
нейросеть: нейросети
ни: ни
имплантат: имплантата
дикий: дикий
забегать: забегали
желвак: желваки
поспешить: поспешил
добавить: добавить
обижаться: обижайтесь
определение: определение
чей: чьи
состоять: состоят
содружество: Содружестве
находиться: находился
ступень: ступени
развитие: развития
исходить: исходя
из: из
удивить: удивлены
менее: менее
знаете: Знаете
доктор: доктор
правильно: правильно
именно: именно
хотя: хотя
верный: вернее
число: числе
суть: суть
важный: важно
произойти: произошло
столько: столько
необычный: необычного
устать: устал
тут: тут
выходить: выходит
рамка: рамки
сверхъестественный: сверхъестественного
согласный: согласен
сейчас: сейчас
уж: уж
много: много
основный: основном
вполне: вполне
сравнение: сравнения
аналог: аналоги
мой: моего
интересный: интересные
догадаться: догадались
ктото: ктото
подсказать: подсказал
гений: гением
достаточно: достаточно
внимательно: внимательно
смотреть: смотреть
понятно: Понятно
наблюдательный: наблюдательны
видимо: Видимо
развить: развит
несильно: несильно
ладно: ладно
разговор: разговор
предстоять: предстоит
пока: пока
подниматься: поднимайтесь
одевайтесь: одевайтесь
пойти: пойдм
поесть: поедим
чтонибудь: чегонибудь
голодный: голоден
заодно: заодно
поговорить: поговорим
волк: волк
вылезти: вылез
до: до
сей: сих
пора: пор
начать: начал
оглядываться: оглядываться
поиск: поисках
одежда: одежды
представлять: Представляем
внимание: вниманию
похожий: похожие
отобрать: отобрали
схожий: схожую
название: названию
смысл: смысле
литература: литературу
предоставить: предоставить
читатель: читателей
больше: больше
вариант: вариантов
обсуждение: Обсуждение
собственный: собственные
мнение: мнения
оставить: Оставьте
думать: думаете
главный: главных
указать: Укажите
конкретно: конкретно
понравиться: понравилось
считать: считаете
