заголовок: Заголовок
олег: Олег
данильченко: Данильченко
имперский: Имперский
вояж: вояж
читать: читать
онлайн: онлайн
бесплатно: бесплатно
адрес: Адрес
здесь: Здесь
быть: будем
возможность: Возможность
весь: всех
текст: текст
электронный: электронной
книга: книге
совершенно: совершенно
целиком: целиком
полный: полную
версия: версию
в: в
некоторый: некоторых
случай: случай
присутствовать: присутствует
краткий: краткое
содержание: содержание
город: Город
м: М
спб: СПб
год: год
выпуск: выпуска
издательство: издательство
аста: АСТ
издательский: Издательский
дом: дом
ленинград: Ленинград
категория: категорию
боевой: боевых
фантастика: фантастика
космический: Космическая
на: на
русский: русском
язык: языке
описание: описание
произведение: произведении
предисловие: предисловие
а: а
так: так
же: же
отзыв: отзывы
посетитель: посетителей
доступный: доступны
портал: портале
библиотека: Библиотека
либ: Либ
кат: Кат
создать: создана
для: для
любитель: любителей
полистать: полистать
хороший: лучшими
книжка: книжку
и: и
предлагать: Предлагаем
широкий: широкий
выбор: выбора
жанр: жанров
любовный: любовные
роман: романы
фэнтези: фэнтези
приключение: приключения
детектив: детективы
триллер: триллеры
эротика: эротика
документальный: документальные
научный: научные
юмористический: юмористические
анекдот: анекдоты
о: о
бизнес: бизнесе
проза: проза
детский: детские
сказка: сказки
религиия: религиии
новинка: новинки
православный: православные
старинный: старинные
про: про
компьютер: компьютеры
программирование: программирование
английский: английском
домоводство: домоводство
поэзия: поэзия
выбрав: Выбрав
по: по
душа: душе
вы: Вы
смочь: сможете
найти: нашли
действительно: действительно
стоить: стоящие
насладиться: насладиться
погружение: погружением
мир: мир
воображение: воображения
прочувствовать: прочувствовать
переживание: переживания
герой: героях
или: или
узнать: Узнайте
себя: себе
чтото: чтото
новый: новые
совершить: совершить
внутренний: внутреннее
открытие: открытие
подробный: Подробная
информация: информацию
ознакомление: ознакомления
текущий: текущему
запрос: запросу
представить: представить
низкий: Ниже
к: К
чтение: чтение
аннотация: аннотацию
зависеть: зависит
от: от
тот: том
что: что
написать: напишите
сам: сам
автор: автора
если: Если
не: не
необходимый: необходимую
комментарий: комментарии
мы: Мы
постараться: постараться
отыскать: отыскать
она: Она
кто: кто
фамилия: фамилию
как: Как
звать: зовут
список: списком
его: его
серия: сериям
уважаемые: Уважаемые
правообладатель: правообладатели
размещать: размещать
наш: наш
сайт: сайте
у: у
любой: любой
зарегистрировать: зарегистрированного
пользователь: пользователя
ваш: ваши
опубликовать: опубликована
без: без
согласие: согласия
пожалуйста: пожалуйста
направить: направьте
жалоба: жалобу
заполните: заполните
форма: форму
обратный: обратной
связь: связи
течение: течение
час: часов
закрыть: закроем
доступ: доступ
нелегально: нелегально
разместить: размещенному
контент: контенту
разбить: разбитый
страница: страницу
система: системой
сохранение: сохранения
место: места
последний: последних
прочитать: прочитанные
позволять: позволяет
с: с
удобство: удобством
необходимость: необходимости
каждый: каждого
раз: раз
заново: заново
искать: искать
остановиться: остановились
поставить: Поставьте
закладка: Закладка
момент: момент
перейти: перейти
который: которая
закончить: закончили
шрифт: Шрифт
интервал: Интервал
средний: Средний
показатель: показателями
обычно: обычно
равняться: равняется
приблизительно: приблизительно
восемьдесят: восьмидесяти
процент: процентам
первоначальный: первоначального
количество: количества
никто: Никто
собираться: собирается
тянуть: тянуть
за: за
ухо: уши
до: до
задача: задача
подготовить: подготовить
высокопрофессиональный: высокопрофессиональных
специалист: специалистов
дорожить: дорожим
свой: свои
репутация: репутацией
центр: центра
право: праву
занимать: занимают
десяток: десятке
территория: территории
содружество: Содружества
я: я
предупредить: предупредил
далее: далее
из: из
вольный: волен
решать: решать
поступить: поступить
теперь: Теперь
знакомиться: знакомиться
сент: Сент
вернуть: Врни
господин: господин
капитан: капитана
заведовать: заведую
секция: секцией
подготовка: подготовки
пилот: пилотов
этот: этих
пять: пять
уважаемый: уважаемый
человек: человек
наставник: наставник
начало: начала
хотеть: хочу
гостья: гостью
прекрасный: Прекрасную
юный: юную
леди: леди
несмотря: несмотря
возраст: возраст
являться: является
выдающийся: выдающийся
один: одного
элентийский: Элентийском
союз: союзе
госпожа: Госпожа
маета: Маета
ре: Ре
орь: Ори
пенферро: Пенферро
клан: клана
цивисса: Цивисс
просить: Прошу
любить: любить
жаловать: жаловать
прибыть: прибыла
программа: программу
обмен: обмена
опыт: опытом
группа: группа
курс: курс
обучение: обучения
курсант: курсант
посчастливится: посчастливится
обучаться: обучаться
придется: придтся
чтобы: чтобы
опозориться: опозориться
двигаться: Двигаемся
далекий: дальше
корь: Кори
лазго: Лазго
призовой: призовые
соревнование: соревнований
между: между
учебный: учебные
база: баз
резерв: резерва
военный: военная
академия: академий
менее: менее
отличный: отличный
орис: Орис
руно: Рун
следующий: Следующим
дуэлло: Дуэлло
годзи: Годзи
прошлое: прошлом
виртуоз: виртуоз
спецподразделение: спецподразделения
гвардия: гвардии
император: императора
ныне: ныне
ценить: цените
ну: Ну
конечно: конечно
ветеран: ветеран
участник: участник
многий: многих
действие: действий
выживать: выживал
самый: самых
невероятноопасный: невероятноопасных
сражение: сражениях
всегда: всегда
приводить: приводил
корабль: корабля
даже: Даже
оставаться: оставалось
только: только
кресло: кресло
черим: Черим
бал: Балах
илья: Ильи
показаться: показалось
голос: голосе
легкий: лгкая
издевка: издевка
когда: Когда
он: ним
представлять: Представляем
пожилой: пожилого
флаглейтенант: флаглейтенант
продолжать: продолжал
отобрать: отобрали
понравиться: понравилось
они: Они
начать: Начнем
пожалуй: пожалуй
порядок: порядке
элентийка: Элентийка
быстро: быстро
зачитать: зачитала
шесть: шесть
имя: имен
среди: среди
оказаться: оказалось
ни: ни
женский: женского
вместе: вместе
покинуть: покинула
помещение: помещении
отбирать: отбирал
очередь: очередь
дойти: дошла
вояка: вояки
брифингзал: брифингзале
остаться: остались
норк: Норк
риго: Риго
еще: ещ
три: три
девчонка: девчонки
получаться: Получается
хватать: хватает
неполный: неполная
новоиспеченный: Новоиспеченный
както: както
виновато: виновато
улыбнуться: улыбнулся
устало: устало
вздохнуть: вздохнул
пригласить: пригласил
следовать: следовать
через: Через
минута: минут
неспешный: неспешной
ходьба: ходьбы
коридор: коридорам
добраться: добрались
называть: называемого
класс: классы
закрепить: закреплен
бы: бы
знать: знал
это: это
то: то
вряд: вряд
ли: ли
догадаться: догадался
меньше: Меньше
похожий: похожие
детство: детства
знакомый: знакомые
земной: земные
иметься: имеется
больший: большую
капсула: капсулу
более: более
ничто: ничего
вот: Вот
тренажерномедицинский: тренажерномедицинских
провести: провдете
часть: часть
время: времени
разработка: разработка
универсальный: Универсальная
совмещать: совмещает
виртуальный: виртуальный
тренажер: тренажер
медицинский: медицинскую
аппаратура: аппаратуру
изучение: изучения
под: под
разгон: разгоном
модель: моделей
но: но
гражданский: гражданских
заведение: заведениях
такой: таких
иметь: имеют
жадный: жадные
корпорант: корпоранты
мочь: могли
позволить: позволить
мой: мои
бытность: бытность
устройство: устройствах
мечтать: мечтать
усмехнуться: усмехнулся
внимательно: внимательно
важный: важно
данные: данные
уже: уже
внести: внесены
также: также
составить: составлена
рецептура: рецептура
разгонный: разгонного
коктейль: коктейля
индивидуально: индивидуально
строго: строго
персональный: персональную
смотреть: Смотрите
перепутать: перепутайте
потому: Потому
опасный: опасно
защита: Защита
дурак: дурака
всякий: всякий
осторожный: осторожны
сожаление: сожалению
прецедент: прецеденты
случаться: случались
извинить: Извините
можно: можно
вопрос: вопросы
перебить: перебил
речь: речь
спрашивайте: Спрашивайте
ээээ: ээээ
лео: Лео
да: Да
ладно: ладно
тянуться: тянуться
плац: плацу
армия: армии
конец: концов
задавать: Задавайте
спасибо: Спасибо
сказать: скажите
правильно: правильно
понять: понял
достаться: достались
дешевый: дешвыми
нейросеть: нейросетями
точно: Точно
высокий: высокими
фпи: ФПИ
сетка: сетками
коллега: коллеги
подтвердить: подтвердил
догадка: догадку
тогда: тогда
ведь: Ведь
логика: логике
вещь: вещей
отставать: отставать
скорость: скорости
несправедливый: несправедливо
обещать: обещал
справедливость: справедливость
привыкайте: Привыкайте
внимание: вниманию
схожий: схожую
название: названию
смысл: смысле
литература: литературу
надежда: надежде
предоставить: предоставить
читатель: читателей
больше: больше
вариант: вариантов
интересный: интересные
обсуждение: Обсуждение
просто: просто
собственный: собственные
мнение: мнения
оставить: Оставьте
думать: думаете
главный: главных
указать: Укажите
конкретно: конкретно
нет: нет
почему: почему
считать: считаете
