заголовок: Заголовок
олег: Олег
данильченко: Данильченко
имперский: Имперский
вояж: вояж
читать: читать
онлайн: онлайн
бесплатно: бесплатно
адрес: Адрес
здесь: Здесь
быть: были
возможность: возможность
весь: вс
текст: текст
электронный: электронной
книга: книге
совершенно: совершенно
целиком: целиком
полный: полную
версия: версию
в: в
некоторый: некоторых
случай: случаях
присутствовать: присутствует
краткий: краткое
содержание: содержание
город: Город
м: М
спб: СПб
год: лет
выпуск: выпуска
издательство: издательство
аста: АСТ
издательский: Издательский
дом: дом
ленинград: Ленинград
категория: категорию
боевой: боевой
фантастика: фантастика
космический: космические
на: на
русский: русском
язык: языке
описание: описание
произведение: произведении
предисловие: предисловие
а: а
так: так
же: же
отзыв: отзывы
посетитель: посетителей
доступный: доступны
портал: портале
библиотека: Библиотека
либ: Либ
кат: Кат
создать: создана
для: для
любитель: любителей
полистать: полистать
хороший: хороший
книжка: книжку
и: и
предлагать: Предлагаем
широкий: широкий
выбор: выбора
жанр: жанров
любовный: любовные
роман: романы
фэнтези: фэнтези
приключение: приключения
детектив: детективы
триллер: триллеры
эротика: эротика
документальный: документальные
научный: научные
юмористический: юмористические
анекдот: анекдоты
о: о
бизнес: бизнесе
проза: проза
детский: детские
сказка: сказки
религиия: религиии
новинка: новинки
православный: православные
старинный: старинные
про: про
компьютер: компьютеры
программирование: программирование
английский: английском
домоводство: домоводство
поэзия: поэзия
выбрав: Выбрав
по: по
душа: душе
вы: Вы
смочь: смогла
найти: найти
действительно: действительно
стоить: стоящие
насладиться: насладиться
погружение: погружением
мир: миров
воображение: воображения
прочувствовать: прочувствовать
переживание: переживания
герой: героях
или: или
узнать: Узнайте
себя: себя
чтото: чмто
новый: новые
совершить: совершить
внутренний: внутреннее
открытие: открытие
подробный: Подробная
информация: информацию
ознакомление: ознакомления
текущий: текущему
запрос: запросу
представить: представлен
низкий: Ниже
к: к
чтение: чтением
аннотация: аннотацию
зависеть: зависит
от: от
тот: той
что: что
написать: напишите
сам: само
автор: автора
если: если
не: не
необходимый: необходимую
комментарий: комментарии
мы: Мы
постараться: постараемся
отыскать: отыскать
она: не
кто: кому
фамилия: фамилию
как: как
звать: звал
список: списком
его: его
серия: сериям
уважаемые: Уважаемые
правообладатель: правообладатели
размещать: размещать
наш: нашу
сайт: сайте
у: у
любой: любой
зарегистрировать: зарегистрированного
пользователь: пользователя
ваш: ваши
опубликовать: опубликована
без: без
согласие: согласия
пожалуйста: пожалуйста
направить: направьте
жалоба: жалобу
заполните: заполните
форма: форму
обратный: обратной
связь: связи
течение: течение
час: часов
закрыть: закроем
доступ: доступ
нелегально: нелегально
разместить: размещенному
контент: контенту
разбить: разбитый
страница: страницу
система: Система
сохранение: сохранения
место: месте
последний: последней
прочитать: прочитанные
позволять: позволяло
с: с
удобство: удобством
необходимость: необходимости
каждый: Каждый
раз: разы
заново: заново
искать: искать
остановиться: остановились
поставить: поставить
закладка: Закладка
момент: момент
перейти: перейти
который: которой
закончить: закончу
шрифт: Шрифт
интервал: Интервал
сестра: сестра
илья: Илья
недоуменный: недоумнно
уставиться: уставился
джойло: Джойл
какой: какой
при: При
тут: тут
твой: твоей
ты: тебя
еще: ещ
понять: Понял
хааа: Хааа
энди: Энди
я: Я
младший: младшая
осклабиться: осклабился
бугай: бугай
ди: Ди
соответственно: соответственно
эн: Эн
мой: моя
малышка: малышка
цвет: Цвет
волос: волос
мама: маму
отец: Отца
знать: знал
мать: мать
один: одно
поднимать: поднимала
жить: жить
небогато: небогато
поэтому: Поэтому
только: только
исполниться: исполнилось
восемнадцать: восемнадцать
пойти: Пойдшь
армия: армию
потом: потом
случиться: случился
налет: налт
фря: Фрею
это: это
планета: планета
называться: называется
пират: Пиратов
фрей: Фрея
окраинный: окраинный
много: много
общий: общем
тоже: Тоже
из: из
метрополия: метрополии
равный: равно
выбить: выбили
рассчитать: рассчитали
они: они
сила: сил
но: Но
погибнуть: Погиб
однако: однако
спрятать: спрятать
тогда: тогда
четырнадцать: четырнадцать
прийтись: придтся
интернат: интернате
до: до
совершеннолетие: совершеннолетия
иногда: иногда
навещать: навещал
ну: Ну
деньга: Денег
помогать: помогал
большой: Больше
ничто: ничего
сделать: сделать
мочь: Могла
понимать: понимаю
служба: служба
хотеть: хочет
накопить: накопленные
средство: средства
вложить: вложить
нейросеть: нейросеть
да: Да
кредит: кредит
взять: взять
военнослужащий: военнослужащий
рассчитывать: рассчитывать
солидный: солидный
жалко: жалко
семья: семья
этот: эту
пигалица: пигалица
попереться: попрлась
аж: аж
хлопнуть: хлопнул
ладонь: ладонью
стол: столу
досада: досады
вот: Вот
сказать: скажи
зачем: Зачем
надо: надо
ее: е
ум: умом
внешность: внешностью
карьера: карьеру
бы: бы
помочь: помог
флот: флот
нет: нет
мозг: мозги
когда: когда
сюда: сюда
распределить: распределили
вообще: вообще
шок: шоке
просидеть: просидеть
какойнибудь: какомнибудь
корабль: корабле
обеспечение: обеспечения
контракт: контракт
приспичить: приспичило
мстить: Мстить
за: за
будто: будто
мало: мало
урод: уродов
давлю: давлю
уж: Уж
доля: долю
надавить: надавил
счет: счта
поверь: поверь
показаться: Показалось
проблема: проблем
пусть: пусть
число: число
голова: головой
назвать: назвала
видеть: видел
ли: ли
теперь: теперь
приглядывать: приглядываю
бояться: боюсь
нарваться: нарвтся
шальной: шальной
выстрел: выстрел
сидеть: сидит
должный: должна
лезть: лезет
вперед: вперед
рука: руки
чесаться: чешутся
чтобы: чтобы
надавать: надавать
круглый: круглой
задница: заднице
номер: номер
ошарашенно: ошарашенно
выдавить: выдавил
молчать: молчит
партизан: партизан
похожий: похожие
тыто: Тыто
вон: вон
дуболом: дуболом
миниатюрный: миниатюрная
удивить: удивил
конечно: конечно
напугать: напугал
короче: Короче
подумать: подумай
плохой: плохого
серьезно: серьзно
тушеваться: тушуйся
уже: уже
взрослый: взрослая
девочка: девочка
выбирать: выбирает
даже: даже
благодарный: благодарен
пять: пять
назад: назад
потерять: потеряла
муж: мужа
служить: служил
парень: парень
он: нему
пиратский: пиратскую
база: баз
трясти: трясли
после: После
цепь: цепи
сорваться: сорвалась
чувство: чувство
самосохранение: самосохранения
ведь: ведь
снайпер: снайпер
электронщик: электронщик
команда: команде
всегда: всегда
сзади: сзади
рожон: рожон
полоумный: полоумная
улыбаться: улыбается
заставить: заставил
оттаять: оттаять
расцвела: расцвела
улыбка: улыбку
памятник: памятник
готовый: готов
смотреть: смотри
сжать: сжал
пудовый: пудовый
кулак: кулак
состояние: состояние
очень: очень
хрупкий: хрупкое
обидеть: Обидеть
стать: станет
хуже: хуже
совсем: совсем
замкнуться: замкнется
отгрызть: отгрызу
такой: таким
говорить: говорить
вскинуться: вскинулся
илюха: Илюха
можното: можното
девушка: девушку
нее: не
горло: горло
грызть: грызть
угодно: угодно
чудной: чудно
илио: Илио
дружище: дружище
чувствовать: чувствую
конец: конца
честной: честным
желание: желания
тянуть: тянуть
лямка: лямку
там: там
махнуть: махнул
подразумевать: подразумевая
земля: Землю
навоеваться: навоевался
самый: самые
гланда: гланды
хотеться: хотелось
свой: своим
посмотреть: Посмотреть
дома: Дома
увлекаться: увлекался
фантастический: Фантастических
перелет: перелеты
мечтать: Мечтал
звезда: звздах
идти: идт
заняться: заняться
дело: делом
многое: многое
отдать: отдал
родной: родной
хорошо: хорошо
отказываться: отказываюсь
хоть: хоть
сейчас: сейчас
жениться: жениться
поход: Походу
влюбиться: влюбился
ухо: уши
другой: другой
мешать: мешает
хотя: Хотя
деватьсято: деватьсято
некуда: некуда
придется: придтся
воспользоваться: воспользоваться
предложение: предложением
погодить: Погоди
пока: пока
расстраиваться: расстраиваться
прогудеть: прогудел
гигант: гигант
прийтито: пришелто
док: док
поговорить: поговорим
намекать: Намекал
касаться: касается
дальнейший: дальнейшей
судьба: судьбы
пообщаться: Пообщайся
вдруг: вдруг
предложить: предложит
давать: Давай
рассказать: расскажешь
добро: Добро
прямо: прямо
дуть: дуй
тянутьто: тянутьто
грег: Грег
пациент: пациенту
устроиться: устроиться
капсула: капсуле
мед: мед
специальный: специальные
аппарат: аппараты
изучение: изучения
знание: знаний
под: под
медикаментозный: медикаментозным
разгон: разгоном
увеличить: увеличить
скорость: скорость
усвоение: усвоения
материал: материала
прийти: пришел
молодец: Молодец
присесть: Присядь
представлять: Представляем
внимание: вниманию
отобрать: отобрали
схожий: схожую
название: названию
смысл: смысле
литература: литературу
надежда: надежде
предоставить: предоставить
читатель: читателей
больше: больше
вариант: вариантов
интересный: интересные
обсуждение: Обсуждение
просто: просто
собственный: собственные
мнение: мнения
оставить: Оставьте
думать: думаете
главный: главных
указать: Укажите
конкретно: конкретно
понравиться: понравилось
почему: почему
считать: считаете
