заголовок: Заголовок
олег: Олег
данильченко: Данильченко
имперский: Имперский
вояж: вояж
читать: читать
онлайн: онлайн
бесплатно: бесплатно
адрес: Адрес
здесь: Здесь
быть: есть
возможность: Возможность
весь: вс
текст: текст
электронный: электронной
книга: книге
совершенно: совершенно
целиком: целиком
полный: полную
версия: версию
в: в
некоторый: некоторых
случай: случае
присутствовать: присутствует
краткий: краткое
содержание: содержание
город: Город
м: М
спб: СПб
год: год
выпуск: выпуска
издательство: издательство
аста: АСТ
издательский: Издательский
дом: дом
ленинград: Ленинград
категория: категорию
боевой: Боевая
фантастика: фантастика
космический: Космическая
на: на
русский: русском
язык: языке
описание: описание
произведение: произведении
предисловие: предисловие
а: а
так: так
же: же
отзыв: отзывы
посетитель: посетителей
доступный: доступны
портал: портале
библиотека: Библиотека
либ: Либ
кат: Кат
создать: создана
для: для
любитель: любителей
полистать: полистать
хороший: хорошую
книжка: книжку
и: и
предлагать: Предлагаем
широкий: широкий
выбор: выбора
жанр: жанров
любовный: любовные
роман: романы
фэнтези: фэнтези
приключение: приключения
детектив: детективы
триллер: триллеры
эротика: эротика
документальный: документальные
научный: научные
юмористический: юмористические
анекдот: анекдоты
о: о
бизнес: бизнесе
проза: проза
детский: детские
сказка: сказки
религиия: религиии
новинка: новинки
православный: православные
старинный: старинные
про: про
компьютер: компьютеры
программирование: программирование
английский: английском
домоводство: домоводство
поэзия: поэзия
выбрав: Выбрав
по: по
душа: душе
вы: Вы
смочь: сможете
найти: нашли
действительно: действительно
стоить: стоящие
насладиться: насладиться
погружение: погружением
мир: мир
воображение: воображения
прочувствовать: прочувствовать
переживание: переживания
герой: героях
или: или
узнать: Узнайте
себя: собой
чтото: чемто
новый: новые
совершить: совершить
внутренний: внутреннее
открытие: открытий
подробный: Подробная
информация: информацию
ознакомление: ознакомления
текущий: текущему
запрос: запросу
представить: представлен
низкий: Ниже
к: к
чтение: чтение
аннотация: аннотацию
зависеть: зависит
от: от
тот: том
что: что
написать: напишите
сам: сама
автор: автора
если: если
не: не
необходимый: необходимую
комментарий: комментарии
мы: Мы
постараться: постараемся
отыскать: отыскать
она: Е
кто: Кто
фамилия: фамилию
как: как
звать: зовут
список: списком
его: его
серия: сериям
уважаемые: Уважаемые
правообладатель: правообладатели
размещать: размещать
наш: нашем
сайт: сайте
у: у
любой: любой
зарегистрировать: зарегистрированного
пользователь: пользователя
ваш: ваши
опубликовать: опубликована
без: без
согласие: согласия
пожалуйста: пожалуйста
направить: направьте
жалоба: жалобу
заполните: заполните
форма: форму
обратный: обратной
связь: связи
течение: течение
час: часов
закрыть: закроем
доступ: доступ
нелегально: нелегально
разместить: размещенному
контент: контенту
разбить: разбитый
страница: страницу
система: системой
сохранение: сохранения
место: места
последний: последней
прочитать: прочитанные
позволять: позволяет
с: с
удобство: удобством
необходимость: необходимости
каждый: каждой
раз: раз
заново: заново
искать: искать
остановиться: остановились
поставить: Поставьте
закладка: Закладка
момент: момент
перейти: перейти
который: которые
закончить: закончили
шрифт: Шрифт
интервал: Интервал
обучение: обучения
вкратце: вкратце
вроде: вроде
разобраться: разобрались
но: но
давать: давая
еще: ещ
рассмотреть: рассмотрим
техника: техника
это: это
тоже: тоже
довольно: довольно
интересный: интересные
из: из
выше: выше
изложить: изложенного
уже: уже
идея: идее
становиться: становится
ясный: ясно
модульный: модульное
легко: легко
поддаваться: поддается
модернизация: модернизации
бы: бы
поточнее: поточнее
выразиться: выразиться
переспециализации: переспециализации
ли: ли
ну: ну
доспециализация: доспециализации
начать: Начнм
несущий: несущий
конструкция: конструкция
просторечие: просторечье
корпус: корпусу
корабль: корабля
кстати: Кстати
собираться: собирается
модульно: модульно
чтобы: чтобы
при: при
большой: большой
желание: желании
вполне: вполне
пример: примеру
можно: Можно
добавить: добавить
секция: секцию
удлинить: удлинив
увеличение: увеличения
грузоподъемность: грузоподъемности
наоборот: наоборот
убрать: убрать
соответственно: соответственно
укоротив: укоротив
облегчить: облегчив
скорость: скорости
разгон: разгона
вот: Вот
один: одного
вариант: вариантов
пере: пере
естественно: естественно
делаться: делается
балда: балды
только: только
лишь: лишь
прихоть: прихоти
владелец: владельца
конечно: конечно
нужный: нужно
рассчитать: рассчитать
потерять: потерял
свой: сво
функциональность: функциональности
прочность: прочности
стать: став
угроза: угрозой
другой: другой
хрен: хрен
он: он
гдето: гдето
отдаление: отдалении
переломиться: переломится
под: под
воздействие: воздействием
центробежный: центробежных
нагрузка: нагрузок
швартовый: швартовых
операция: операциях
доку: доку
тото: тото
оно: оно
за: за
зорко: зорко
следить: следят
специальный: специальные
служба: службы
поэтому: поэтому
инициативный: инициативный
идиот: идиотов
коих: коих
много: много
советский: советские
время: времена
российский: российском
торговый: торговом
флот: флоте
содружество: Содружестве
вовремя: вовремя
бить: бьют
кривой: кривым
рука: рукам
претворять: претворять
жизнь: жизнь
больной: больные
фантазия: фантазии
бывать: бывало
знать: знаете
какойнибудь: какомнибудь
шибко: шибко
грамотный: грамотный
личный: личному
мнение: мнения
придурок: придурок
решить: решит
обрезать: обрезать
гребной: гребного
винт: винта
лопасть: лопасти
десяток: десяток
сантиметр: сантиметров
то: то
экономия: экономия
топливо: топливо
весьма: весьма
ощутимый: ощутимой
такой: такую
кощунство: кощунство
никак: никак
сказаться: скажется
основный: основных
характеристика: характеристиках
даже: даже
математический: математические
расчет: расчты
приложить: приложит
подтверждать: подтверждающие
данный: данное
непотребство: непотребство
дятел: дятел
углядеть: углядит
эпохальный: эпохальное
вуаля: вуаля
сухой: Сухой
док: док
дядя: дядя
вася: Вася
сварщик: сварщик
автоген: автогеном
насрать: насрать
палец: пальцем
ткнуть: ткнули
отхреначить: отхреначил
утрировать: Утрирую
прецедент: прецеденты
случаться: случались
потом: потом
начинаться: начинается
бешеный: Бешеная
вибрация: вибрация
дохрен: дохрена
всякий: всяких
срань: срань
до: до
куча: кучи
вытекать: вытекающей
этот: эта
приходиться: приходится
разгребать: разгребать
экипаж: экипажи
ведь: ведь
никто: никто
слушать: слушал
самый: самые
когда: когда
они: Они
крик: криком
кричать: кричали
пытаться: пытаясь
помешать: помешать
доморощенный: доморощенным
теоретик: теоретикам
плавсостав: плавсостав
да: да
вечно: вечно
ныть: ноют
запчасть: запчасти
подавать: подавай
качественный: качественное
понимать: понимаешь
требовать: требуют
дорогой: дорогое
дешевлето: дешевлето
топочный: топочный
мазут: мазут
бункер: бункер
зафигачить: зафигачить
куда: куда
деться: денутся
скормят: Скормят
дерьмо: дерьмо
блаженная: блаженные
день: днм
ночь: ночью
рак: раком
машина: машине
стоять: стоят
ремонтировать: ремонтируя
выходить: выходящую
строй: строя
топливный: топливную
аппаратура: аппаратуру
их: их
проблема: проблемы
рацуху: рацуху
задвинуть: задвинули
деньгу: деньгу
нее: не
получить: получили
благополучно: благополучно
давно: давно
потратить: потратили
сейчас: сейчас
сидеть: сидим
институт: институте
преподавательский: преподавательской
работа: работа
кичиться: кичимся
народный: народными
достижение: достижениями
плевать: плевать
рацуха: рацуха
оказаться: оказалась
лажа: лажей
деньга: деньги
ремонт: ремонт
ликвидация: ликвидацию
последствие: последствий
тратиться: тратились
огромный: огромные
иной: иных
проще: проще
пароход: пароход
построить: построить
заключаться: заключается
умниктеоретик: умникамитеоретиками
отвлечься: отвлеклись
разговорто: разговорто
цивилизация: цивилизации
тут: тут
больший: большей
часть: части
бороздящие: бороздящие
космос: космос
переделка: переделки
проверяться: проверяются
соответствовать: соответствуют
принять: принятым
общий: общем
стандарт: стандартам
херня: херню
извинить: извините
сорри: Сорри
мой: мой
французский: французский
однако: Однако
изменение: изменения
сделать: сделаны
грамотно: грамотно
ради: ради
бог: бога
препятствовать: препятствует
более: более
подобный: подобные
вещь: вещи
учитываться: учитываются
вноситься: вносятся
впоследствии: впоследствии
база: базы
знание: знаний
дабы: дабы
распространять: распространять
полезный: полезный
опыт: опыт
масса: массы
понятный: понятно
нести: несущий
главный: главных
составлять: составляющих
штуковина: штуковина
никуда: никуда
полететь: полетит
надо: Надо
двигать: двигать
выползать: выползает
арена: арену
двигательный: двигательная
установка: установка
водиться: водится
разный: разные
разниться: разнятся
между: между
начинать: начиная
размер: размеров
предназначение: предназначения
основной: Основные
маршевый: маршевые
двигатель: двигатель
предназначить: предназначены
непосредственно: непосредственно
придавать: придают
изначально: изначально
статичный: статичному
поступательный: поступательное
движение: движение
какойто: какойто
мера: мере
маневренность: маневренность
иметься: имеется
функция: функций
вектор: вектора
тяга: тяги
также: также
маневровый: маневровые
тормозной: тормозные
вариация: вариаций
например: например
совмещать: совмещающих
несколько: несколько
флакон: флаконе
хозяйство: хозяйство
наверное: наверное
догадаться: догадались
совать: совать
угодно: угодно
верный: вернее
туд: туды
влезть: влезет
судовой: судовой
каркас: каркас
дело: дело
выдержать: выдержит
снять: снять
засандалить: засандалить
просто: просто
купить: купить
мощный: мощный
нештатный: нештатный
воткнуть: воткнуть
корыто: корыто
говориться: говорилось
позволить: позволит
забывать: забывать
должный: должна
потянуть: потянуть
штатный: штатная
энергетический: энергетическая
представлять: Представляем
внимание: вниманию
похожий: похожие
отобрать: отобрали
схожий: схожую
название: названию
смысл: смысле
литература: литературу
надежда: надежде
предоставить: предоставить
читатель: читателей
больше: больше
обсуждение: Обсуждение
собственный: собственные
оставить: Оставьте
думать: думаете
указать: Укажите
конкретно: конкретно
понравиться: понравилось
нет: нет
почему: почему
считать: считаете
