заголовок: Заголовок
олег: Олег
данильченко: Данильченко
имперский: Имперский
вояж: вояж
читать: читал
онлайн: онлайн
бесплатно: бесплатно
адрес: Адрес
здесь: Здесь
быть: быть
возможность: Возможность
весь: Все
текст: текст
электронный: электронной
книга: книге
совершенно: совершенно
целиком: целиком
полный: полную
версия: версию
в: в
некоторый: некоторые
случай: случаях
присутствовать: присутствует
краткий: краткое
содержание: содержание
город: Город
м: М
спб: СПб
год: год
выпуск: выпуска
издательство: издательство
аста: АСТ
издательский: Издательский
дом: дом
ленинград: Ленинград
категория: категорию
боевой: боевого
фантастика: фантастика
космический: Космическая
на: на
русский: русском
язык: языке
описание: описание
произведение: произведении
предисловие: предисловие
а: а
так: так
же: же
отзыв: отзывы
посетитель: посетителей
доступный: доступны
портал: портале
библиотека: Библиотека
либ: Либ
кат: Кат
создать: создана
для: для
любитель: любителей
полистать: полистать
хороший: Лучше
книжка: книжку
и: и
предлагать: Предлагаем
широкий: широкий
выбор: выбора
жанр: жанров
любовный: любовные
роман: романы
фэнтези: фэнтези
приключение: приключения
детектив: детективы
триллер: триллеры
эротика: эротика
документальный: документальные
научный: научные
юмористический: юмористические
анекдот: анекдоты
о: о
бизнес: бизнесе
проза: проза
детский: детские
сказка: сказки
религиия: религиии
новинка: новинки
православный: православные
старинный: старинные
про: про
компьютер: компьютеры
программирование: программирование
английский: английском
домоводство: домоводство
поэзия: поэзия
выбрав: Выбрав
по: по
душа: душу
вы: Вы
смочь: сможете
найти: нашли
действительно: действительно
стоить: стоящие
насладиться: насладиться
погружение: погружением
мир: мира
воображение: воображения
прочувствовать: прочувствовать
переживание: переживания
герой: героях
или: или
узнать: Узнайте
себя: себя
чтото: чтото
новый: новые
совершить: совершить
внутренний: внутреннее
открытие: открытие
подробный: Подробная
информация: информацию
ознакомление: ознакомления
текущий: текущему
запрос: запросу
представить: представил
низкий: Ниже
к: к
чтение: чтение
аннотация: аннотацию
зависеть: зависит
от: От
тот: тем
что: что
написать: напишите
сам: самого
автор: автора
если: Если
не: не
необходимый: необходимо
комментарий: комментарии
мы: Мы
постараться: постараемся
отыскать: отыскать
она: е
кто: кто
фамилия: фамилию
как: как
звать: зовут
список: списком
его: его
серия: сериям
уважаемые: Уважаемые
правообладатель: правообладатели
размещать: размещать
наш: нашем
сайт: сайте
у: у
любой: любой
зарегистрировать: зарегистрированного
пользователь: пользователя
ваш: ваши
опубликовать: опубликована
без: без
согласие: согласия
пожалуйста: пожалуйста
направить: направьте
жалоба: жалобу
заполните: заполните
форма: форму
обратный: обратной
связь: связи
течение: течение
час: часов
закрыть: закроем
доступ: доступ
нелегально: нелегально
разместить: размещенному
контент: контенту
разбить: разбитый
страница: страницу
система: Система
сохранение: сохранения
место: мест
последний: последнюю
прочитать: прочитанные
позволять: позволяет
с: с
удобство: удобством
необходимость: необходимости
каждый: каждое
раз: раз
заново: заново
искать: искать
остановиться: остановились
поставить: Поставьте
закладка: Закладка
момент: момент
перейти: перейти
который: которой
закончить: закончили
шрифт: Шрифт
интервал: Интервал
центр: центре
зал: Зал
церемониальный: Церемониальный
поклон: поклоны
сторона: сторонам
главный: главных
трибуна: трибунах
совсем: Совсем
обязательный: обязательный
три: три
зритель: зрителям
собственно: собственно
комплекс: комплекс
илья: Илья
полностью: полностью
отдаться: отдался
движение: движение
это: этому
он: он
научить: научил
еще: ещ
отец: отец
отрешившись: Отрешившись
окружать: окружающей
действительность: действительности
просто: просто
выполнять: выполнял
набор: набор
упражнение: упражнений
наслаждаться: наслаждался
приятный: Приятно
всетаки: встаки
черт: черт
взять: взял
чувствовать: чувствовать
здоровый: здоровым
понять: понять
увечный: увечным
клеточка: клеточка
хорошо: хорошо
тренировать: тренированного
тело: тело
петь: пела
унисон: унисон
ничто: ничего
видеть: видишь
вокруг: вокруг
получать: получал
удовольствие: удовольствием
знание: знаний
искусство: искусства
этот: этого
получить: полученные
из: из
база: баз
освоить: освоенные
практика: практике
итог: итоге
гармонично: гармонично
слиться: слились
земной: земными
аналог: аналогами
вносить: внося
свой: свое
лепта: лепту
замечать: замечал
действовать: действуя
рефлекс: рефлексах
вот: вот
завороженно: завороженно
следить: следили
за: за
двигаться: двигаться
курсант: курсант
арена: арены
вроде: Вроде
бы: бы
но: Но
рисунок: рисунок
сейчас: сейчас
плести: плел
землянин: землянин
более: более
красивый: Красив
красота: красотой
когда: Когда
становиться: становится
понятный: понятно
человек: Люди
буквально: буквально
проживать: проживает
пропускать: пропуская
через: через
хватать: хватало
только: Только
музыка: музыке
работать: работал
под: под
звук: звуки
вальс: вальса
звучать: звучащие
внутри: внутри
затапливать: затапливая
заставлять: заставляя
такт: такт
можно: Можно
б: б
долго: долго
куролесить: куролесить
кураж: кураже
пора: пора
честь: честь
знать: знает
финальный: Финальный
аккорд: аккорд
отзвучать: отзвучал
плавно: плавно
завершить: завершив
связка: связку
парень: парень
выйти: вышел
транс: транса
оглянувшись: Оглянувшись
притихнуть: притихший
снова: снова
изобразить: изобразил
начинать: начиная
взорваться: взорвался
одобрительный: одобрительными
крик: криками
шум: шум
стоять: стоял
неимоверный: неимоверный
они: ними
подумать: подумал
опешить: опешивший
илюха: Илюху
вскакивать: вскакивали
выражать: выражая
восхищение: восхищение
растерянно: растерянно
озираться: озирался
понимать: понимает
происходить: происходит
несколько: несколько
поутихнуть: поутих
слово: слово
командир: командир
курс: курса
пилот: пилотов
вернуть: Врни
важный: важно
прокашляться: прокашлялся
прочищать: прочищая
горло: горло
весьма: весьма
зрелищный: зрелищно
начать: начал
заказывать: заказывали
представление: представления
допустить: допустил
ошибка: ошибок
пригласить: приглашенный
уважаемый: уважаемый
инструктор: инструктор
рукопашный: рукопашного
бой: боя
обратить: обратил
внимание: вниманию
возмущенно: возмущенно
загудеть: загудел
тихий: Тихо
тихо: Тихо
повысить: повысил
голос: голос
капитан: капитан
я: я
говорить: говорит
возмущение: возмущение
ведь: ведь
лео: Лео
особенный: особенное
однако: Однако
должный: должны
непредвзятый: непредвзяты
господин: господин
бал: Балах
почемуто: почемуто
согласный: согласен
давать: давайте
спросить: спросим
оценивать: оценивает
действие: действия
почувствовать: почувствовал
неладный: неладное
точно: точно
похоже: Похоже
вести: ведт
какойто: какогото
игра: игру
скорый: скорее
разменный: разменная
монета: монета
казаться: Кажись
победа: победой
полигон: полигоне
спутать: спутали
карта: карты
война: войне
против: против
черим: Черим
сделать: сделал
ставка: ставку
хотя: хотя
вряд: вряд
ли: ли
почему: почему
именно: именно
иначе: иначе
дело: дело
дополнительный: дополнительными
картридж: картриджами
всплыть: всплыло
наружу: наружу
разница: разницы
нет: нет
мочь: Может
пока: пока
время: время
хотеть: хочет
устранить: устранить
досадный: досадное
недоразумение: недоразумение
подводить: Подводя
тестовый: тестового
спарринг: спарринг
опытный: опытным
возможно: Возможно
даже: даже
серьезно: серьезно
покалечить: покалечить
хуже: хуже
глубоко: глубоко
копать: копать
щелкнуть: щлкну
ласт: ластами
да: Да
никто: никто
до: до
дикарь: дикаря
чуть: чуть
большой: больше
месяц: месяца
назад: назад
принять: принявшего
гражданство: гражданство
рассчитывать: рассчитывает
ди: Ди
мой: моей
голова: голове
теперь: теперь
представлять: Представляем
хихикнуть: хихикнула
ты: ты
чапай: Чапай
думать: думаете
прикрикнуть: прикрикнул
мысленно: мысленно
сказать: скажете
простоять: простоим
минута: минуту
мастер: мастера
больше: больше
какой: какими
имплант: имплантами
снабдить: снабжн
уж: уж
легко: легко
выдержать: выдержим
твой: твоей
уверенность: уверенность
ссать: ссы
босс: босс
чикипуки: чикипуки
откуда: Откуда
поразиться: поразился
память: памяти
вестимо: вестимо
общаться: общаюсь
постигать: постигаю
великий: великий
могучий: могучий
классика: классику
изучать: изучала
положенный: положено
то: то
превеликий: превеликим
цыц: Цыц
устройство: устройство
неуч: неуча
слышать: слышу
прозвучать: Прозвучавший
вопрос: вопрос
вывести: вывел
раздумье: раздумий
считать: считаете
выполнить: выполнил
ответить: ответил
отвлечься: отвлекся
немного: немного
поэтому: поэтому
упустить: упустил
такой: Такое
тоже: тоже
случаться: случается
согласиться: согласился
тогда: Тогда
установить: установить
истина: истину
правило: Правила
допускать: допускают
проведение: проведение
поединок: поединка
выяснение: выяснения
правый: прав
конечный: конечном
готовый: готовы
похожий: похожие
отобрать: отобрали
схожий: схожую
название: названию
смысл: смысле
литература: литературу
надежда: надежде
предоставить: предоставить
читатель: читателей
вариант: вариантов
интересный: интересные
обсуждение: Обсуждение
собственный: собственные
мнение: мнения
оставить: Оставьте
указать: Укажите
конкретно: конкретно
понравиться: понравилось
