заголовок: Заголовок
олег: Олег
данильченко: Данильченко
имперский: Имперский
вояж: вояж
читать: читать
онлайн: онлайн
бесплатно: бесплатно
адрес: Адрес
здесь: Здесь
быть: были
возможность: возможность
весь: вс
текст: текст
электронный: электронной
книга: книге
совершенно: совершенно
целиком: целиком
полный: полную
версия: версию
в: в
некоторый: некоторых
случай: случае
присутствовать: присутствует
краткий: краткое
содержание: содержание
город: Город
м: М
спб: СПб
год: год
выпуск: выпуска
издательство: издательство
аста: АСТ
издательский: Издательский
дом: дом
ленинград: Ленинград
категория: категорию
боевой: Боевая
фантастика: фантастика
космический: Космическая
на: на
русский: русском
язык: языка
описание: описание
произведение: произведении
предисловие: предисловие
а: а
так: так
же: же
отзыв: отзывы
посетитель: посетителей
доступный: доступны
портал: портале
библиотека: Библиотека
либ: Либ
кат: Кат
создать: создана
для: для
любитель: любителей
полистать: полистать
хороший: Лучше
книжка: книжку
и: и
предлагать: предлагая
широкий: широкий
выбор: выбора
жанр: жанров
любовный: любовные
роман: романы
фэнтези: фэнтези
приключение: приключения
детектив: детективы
триллер: триллеры
эротика: эротика
документальный: документальные
научный: научные
юмористический: юмористические
анекдот: анекдоты
о: о
бизнес: бизнесе
проза: проза
детский: детские
сказка: сказки
религиия: религиии
новинка: новинки
православный: православные
старинный: старинные
про: про
компьютер: компьютеры
программирование: программирование
английский: английском
домоводство: домоводство
поэзия: поэзия
выбрав: Выбрав
по: по
душа: душе
вы: Вы
смочь: сможете
найти: найти
действительно: действительно
стоить: стоящие
насладиться: насладиться
погружение: погружением
мир: мир
воображение: воображения
прочувствовать: прочувствовать
переживание: переживания
герой: героях
или: или
узнать: Узнайте
себя: собой
чтото: чтото
новый: новые
совершить: совершить
внутренний: внутреннее
открытие: открытие
подробный: Подробная
информация: информацию
ознакомление: ознакомления
текущий: текущему
запрос: запросу
представить: представлен
низкий: низким
к: к
чтение: чтение
аннотация: аннотацию
зависеть: зависит
от: от
тот: том
что: что
написать: напишите
сам: сама
автор: автора
если: если
не: не
необходимый: необходимую
комментарий: комментарии
мы: Мы
постараться: постараемся
отыскать: отыскать
она: ею
кто: кто
фамилия: фамилию
как: как
звать: зовут
список: списком
его: его
серия: сериям
уважаемые: Уважаемые
правообладатель: правообладатели
размещать: размещать
наш: нашем
сайт: сайте
у: у
любой: любой
зарегистрировать: зарегистрированного
пользователь: пользователя
ваш: ваши
опубликовать: опубликована
без: без
согласие: согласия
пожалуйста: пожалуйста
направить: направьте
жалоба: жалобу
заполните: заполните
форма: форму
обратный: обратной
связь: связи
течение: течение
час: часов
закрыть: закроем
доступ: доступ
нелегально: нелегально
разместить: размещенному
контент: контенту
разбить: разбитый
страница: страницу
система: Система
сохранение: сохранения
место: месте
последний: последний
прочитать: прочитанные
позволять: позволяет
с: с
удобство: удобством
необходимость: необходимости
каждый: каждый
раз: раз
заново: заново
искать: ищи
остановиться: остановились
поставить: Поставьте
закладка: Закладка
момент: момент
перейти: перейти
который: которые
закончить: закончили
шрифт: Шрифт
интервал: Интервал
ладно: Ладно
черт: черт
такой: такой
отсутствие: Отсутствие
огонь: огня
дать: дало
хорошо: хорошо
прицелиться: прицелиться
послать: послать
граната: гранату
точно: точно
под: под
нога: ноги
противник: противнику
вог: ВОГ
подвести: подвела
смысл: смысле
попасть: попала
куда: куда
надо: надо
примерно: примерно
бабахнуть: бабахнула
ожидаться: ожидалось
пронять: Проняло
но: Но
опять: опять
ненадолго: ненадолго
взрывной: Взрывной
волна: волной
трое: троих
бронированный: бронированных
гаврик: гавриков
раскидать: раскидало
разный: разные
сторона: стороны
появиться: появившаяся
ехидный: ехидная
улыбка: улыбка
сползти: сползла
илюхин: Илюхиного
лицо: лицо
когда: когда
этот: эту
сволочь: сволочи
наплевать: наплевав
должный: должны
убить: убиты
бодренько: бодренько
подняться: поднялись
ни: ни
бывать: бывало
потрусить: потрусили
далекий: дальше
илья: Илья
поправить: поправил
отвалиться: отвалившуюся
челюсть: челюсть
горько: горько
усмехнуться: усмехнулся
пипец: Пипец
котенок: котенку
пробормотать: пробормотал
он: он
иметь: имея
вид: виду
потянуться: потянулся
за: за
рубчатый: рубчатым
корпус: корпусом
эфка: эфки
встречать: Встречай
братуха: братуха
сделать: сделать
ничто: ничего
успеть: успел
тело: Тело
выгнуть: выгнуло
дуга: дугой
наступить: наступила
уже: уже
давно: давно
привычный: привычная
темнота: темнота
глава: Глава
сознание: сознание
прийти: пришел
както: както
рывок: рывком
осознать: осознал
небольшой: небольшой
квадратный: квадратной
комната: комнату
потолок: потолок
стена: Стены
металлический: металлическим
поди: поди
разобраться: разберись
мочь: может
это: это
штукатурка: штукатурка
цвет: цвет
сидеть: Сидел
стул: стуле
всякий: всяком
очень: очень
похожий: похожие
раздеть: раздетый
пояс: пояс
зафиксировать: зафиксированный
правило: правилам
запястье: Запястья
прижать: прижаты
подлокотник: подлокотникам
хомут: хомутов
тоже: тоже
пристегнуть: пристегнуты
перед: Перед
узреть: узрел
колоритный: колоритный
персонаж: персонаж
стоять: стоял
возле: возле
стол: стола
тут: Тут
наблюдать: наблюдал
реакция: реакцией
илюха: Илюху
невысокий: Невысокого
рост: Ростом
мужичок: Мужичок
метр: метр
семьдесят: семьдесят
большой: больше
одеть: одетый
обтягивать: обтягивающий
комбинезон: комбинезон
индиго: индиго
лысый: лысый
причем: Причем
просто: просто
абсолютно: Абсолютно
даже: даже
бровь: бровей
ресница: ресницами
отсутствовать: отсутствовали
класс: класс
однако: Однако
какой: Какой
контраст: контраст
подумать: подумал
усмехнувшись: усмехнувшись
вспоминать: вспоминая
памятный: памятного
чеченец: чеченца
потом: потом
удивление: удивлением
понять: понял
страх: страха
нет: нет
казаться: Казалось
бы: бы
обязанный: обязан
бояться: боялся
учитывать: учитывая
ситуация: ситуации
оказаться: оказался
видимо: Видимо
устать: устало
напряжение: напряжения
связать: связанного
событие: событиями
отключить: отключило
функция: функцию
ненадобность: ненадобностью
между: между
ответ: ответ
сказать: сказал
возможно: возможно
спросить: спросил
догадываться: догадывался
конкретно: конкретно
еще: ещ
спрашивать: спрашивать
кроме: Кроме
да: да
откуда: откуда
ответить: ответил
хотя: Хотя
ясный: ясно
толкуто: толкуто
общий: общем
понимать: понимаю
я: мне
являться: являлся
полиглот: полиглотом
грех: грехом
пополам: пополам
словарь: словарм
изъясняться: изъясняться
слух: слух
вполне: вполне
наверное: наверное
определить: определить
многий: многие
из: из
земной: земные
только: только
произнести: произнеснном
диалект: диалекты
чувствовать: чувствовал
интуитивный: интуитивном
уровень: уровне
мужик: мужик
нахмуриться: нахмурился
сложно: Сложно
хмуриться: хмуриться
получиться: получилось
повысить: Повысил
голос: голосу
снова: снова
повторить: повторил
свой: свой
вопрос: вопросы
пожать: пожал
плечо: плечами
оставаться: оставалось
делать: делать
ты: ты
равный: равно
поход: походу
начинать: начинал
злиться: злиться
порозоветь: порозовело
рот: рот
открыться: открылся
выдать: выдал
длинный: длинную
гневный: гневную
речь: речь
переводчик: переводчика
понятный: понятно
грозиться: грозится
серьезный: серьзными
неприятность: неприятностями
пасть: падут
голова: голова
сейчас: сейчас
прекратить: прекратит
валять: валять
дурак: дурака
заговорить: заговорить
почеловечески: почеловечески
ихний: ихней
мов: мове
рад: рад
хоть: хоть
треснуть: тресни
то: то
великий: великом
водиться: водится
могучий: могучем
молчать: молчал
вариант: вариантов
попытаться: попытался
придать: придать
успокаивать: успокаивающие
нотка: нотки
слышать: Слышь
дядя: дядя
рвать: рви
связка: связки
кричать: кричишь
знание: знаний
прибавиться: прибавится
ду: Ду
ю: ю
спик: спик
инглишь: инглишь
шпрехен: Шпрехен
зи: зи
дойчь: дойчь
парль: Парле
ву: ву
франсе: франсе
вот: Вот
короче: Короче
рассвирепеть: рассвирепел
всерьез: всерьз
сменить: сменило
теперь: теперь
колер: колеру
близкий: ближе
спелый: спелому
помидор: помидору
подскочить: Подскочив
вплотную: вплотную
замахнуться: замахнулся
отвесить: отвесил
оглушительный: оглушительную
пощечина: пощечину
загудеть: загудело
помотать: помотал
пытаться: пытался
избавиться: избавиться
звон: звона
ухо: ушах
ну: Ну
начинаааться: начинааается
вслух: вслух
зло: зло
посмотреть: посмотрев
собеседник: собеседника
дебил: дебил
пристрелить: пристрели
ейбогу: ейбогу
проще: проще
другой: другой
вряд: вряд
ли: ли
стать: стал
грубить: грубить
уж: уж
теперьто: теперьто
терять: Терять
более: более
нечего: нечего
окромя: окромя
собственный: собственные
цепь: цепей
данный: данном
стальной: стальных
угрожающе: угрожающе
промычал: промычал
похоже: похоже
похорошему: похорошему
получить: получил
ожидать: ожидаемое
пойти: пошел
дятел: дятел
продолжать: продолжая
сверлить: сверлить
злобный: злобным
взгляд: взглядом
наверно: наверно
наконецтаки: наконецтаки
дойти: дошло
общаться: общаться
дохлый: дохлый
номер: номер
поразмышляв: Поразмышляв
минута: минут
закатить: закатил
глаз: глазу
будто: будто
свод: сводами
череп: черепа
интересовать: интересующие
через: через
пара: пару
тихий: тихим
шелест: шелестом
незаметный: незаметная
дверь: дверь
скользнуть: скользнула
вбок: вбок
войти: вошедшего
менее: менее
чем: чем
первый: первого
весьма: весьма
поболее: поболее
этак: этак
восемьдесят: восемьдесят
потянуть: потянет
сложение: сложением
серьезно: серьзно
покрепче: покрепче
одетый: Одет
однотипный: однотипно
разница: Разница
заключаться: заключалась
отличие: отличие
число: числе
шея: шея
ниже: ниже
комбез: комбезом
видно: видно
покрыть: покрыты
разноцветный: разноцветными
татуировка: татуировками
плюс: Плюс
вроде: вроде
кейс: кейса
правый: правой
рука: руке
представлять: Представляем
внимание: вниманию
отобрать: отобрали
схожий: схожую
название: названию
литература: литературу
надежда: надежде
предоставить: предоставить
читатель: читателей
больше: больше
интересный: интересные
обсуждение: Обсуждение
мнение: мнения
оставить: Оставьте
думать: думаете
главный: главных
указать: Укажите
понравиться: понравилось
почему: почему
считать: считаете
