заголовок: Заголовок
олег: Олег
данильченко: Данильченко
имперский: Имперский
вояж: вояж
читать: читать
онлайн: онлайн
бесплатно: бесплатно
адрес: Адрес
здесь: Здесь
быть: будет
возможность: Возможность
весь: вс
текст: текст
электронный: электронной
книга: книге
совершенно: совершенно
целиком: целиком
полный: полную
версия: версию
в: в
некоторый: некоторых
случай: случаях
присутствовать: присутствует
краткий: краткое
содержание: содержание
город: Город
м: М
спб: СПб
год: год
выпуск: выпуска
издательство: издательство
аста: АСТ
издательский: Издательский
дом: дом
ленинград: Ленинград
категория: категорию
боевой: боевых
фантастика: фантастика
космический: Космическая
на: на
русский: русском
язык: языке
описание: описание
произведение: произведении
предисловие: предисловие
а: а
так: так
же: же
отзыв: отзывы
посетитель: посетителей
доступный: доступны
портал: портале
библиотека: Библиотека
либ: Либ
кат: Кат
создать: создана
для: для
любитель: любителей
полистать: полистать
хороший: хорошо
книжка: книжку
и: и
предлагать: Предлагаем
широкий: широкий
выбор: выбора
жанр: жанров
любовный: любовные
роман: романы
фэнтези: фэнтези
приключение: приключения
детектив: детективы
триллер: триллеры
эротика: эротика
документальный: документальные
научный: научные
юмористический: юмористические
анекдот: анекдоты
о: о
бизнес: бизнесе
проза: проза
детский: детские
сказка: сказки
религиия: религиии
новинка: новинки
православный: православные
старинный: старинные
про: про
компьютер: компьютеры
программирование: программирование
английский: английском
домоводство: домоводство
поэзия: поэзия
выбрав: Выбрав
по: по
душа: душе
вы: Вы
смочь: сможете
найти: найдя
действительно: действительно
стоить: стоящие
насладиться: насладиться
погружение: погружением
мир: мир
воображение: воображения
прочувствовать: прочувствовать
переживание: переживания
герой: героях
или: или
узнать: Узнайте
себя: себя
чтото: Чтото
новый: новые
совершить: совершить
внутренний: внутреннее
открытие: открытие
подробный: Подробная
информация: информацию
ознакомление: ознакомления
текущий: текущему
запрос: запросу
представить: представлен
низкий: Ниже
к: к
чтение: чтение
аннотация: аннотацию
зависеть: зависит
от: от
тот: тех
что: что
написать: напишите
сам: самом
автор: автора
если: Если
не: не
необходимый: необходимую
комментарий: комментарии
мы: Мы
постараться: постараемся
отыскать: отыскать
она: е
кто: кто
фамилия: фамилию
как: как
звать: зовут
список: списком
его: его
серия: сериям
уважаемые: Уважаемые
правообладатель: правообладатели
размещать: размещать
наш: нашем
сайт: сайте
у: у
любой: любой
зарегистрировать: зарегистрированного
пользователь: пользователя
ваш: ваши
опубликовать: опубликована
без: без
согласие: согласия
пожалуйста: пожалуйста
направить: направьте
жалоба: жалобу
заполните: заполните
форма: форму
обратный: обратной
связь: связи
течение: течение
час: часов
закрыть: закроем
доступ: доступ
нелегально: нелегально
разместить: размещенному
контент: контенту
разбить: разбитый
страница: страницу
система: Система
сохранение: сохранения
место: местам
последний: последний
прочитать: прочитанные
позволять: позволяет
с: С
удобство: удобством
необходимость: необходимости
каждый: каждый
раз: раз
заново: заново
искать: искать
остановиться: остановились
поставить: Поставьте
закладка: Закладка
момент: момент
перейти: перейти
который: которое
закончить: закончили
шрифт: Шрифт
интервал: Интервал
разрешить: Разрешите
помочь: помог
уважаемый: уважаемый
спросить: спросил
он: его
дожидаться: дожидаясь
ответ: ответа
начать: начал
складывать: складывать
рассыпать: рассыпанное
имущество: имущество
дедка: Дедок
хмыкнуть: хмыкнул
но: Но
ничто: ничего
сказать: скажите
продолжить: продолжить
секунда: секунду
прервать: прерванное
занятие: занятие
четыре: четыре
рука: рукой
они: они
быстро: быстро
справиться: справились
когда: когда
илья: Илья
разогнуться: разогнулся
укладывая: укладывая
фрагмент: фрагмент
бронь: брони
платформа: платформу
заметить: заметил
старик: старик
ухмыляясь: ухмыляясь
смотреть: смотрит
оглядев: Оглядев
смешной: смешного
обнаружить: обнаружил
полотенце: Полотенце
обмотать: обмотанное
вокруг: вокруг
талия: талии
мокрый: мокрый
пот: пота
спортивный: спортивный
костюм: костюм
держать: держал
счет: счт
спрашивается: спрашивается
лыба: лыбу
давить: давит
откуда: Откуда
ты: тебе
такой: такой
сердобольный: сердобольный
нынче: нынче
мода: моде
передвижение: передвижение
школа: школы
голый: голом
вид: виде
проскрипеть: проскрипел
дед: деду
я: я
тренировка: тренировки
буркнуть: буркнул
илюха: Илюха
поражаться: поражаясь
неблагодарный: неблагодарному
извинить: Извините
помешать: помешает
развлекаться: развлекаться
добавить: добавил
развернуться: развернулся
намереваться: намереваясь
свой: своих
путь: путь
обидчивый: Обидчивая
молодежь: молодежь
пойти: пошла
никакой: никакого
уважение: уважения
старость: старости
заговорить: заговорил
старикашка: старикашка
нос: нос
задрать: задрал
нога: ноги
надо: надо
упасть: упасть
хватить: Хватило
бы: бы
элементарный: элементарного
спасибо: Спасибо
этот: этими
куча: куча
барахло: барахла
дотащить: дотащить
до: до
арсенал: арсенал
поразившись: Поразившись
наглость: наглости
сначала: Сначала
потом: потом
еще: ещ
разгрузить: разгрузить
раскладывать: раскладывая
это: Это
указывать: указывал
оказаться: оказался
приличный: приличных
размер: размеров
кроме: кроме
прочий: прочие
тут: тут
мастерская: мастерскую
ремонт: ремонту
настройка: настройке
богатство: богатства
естественно: Естественно
землянин: землянин
сразу: сразу
возникнуть: возникла
вопрос: вопросов
спрашивать: спрашивал
выясниться: выяснилось
зевран: Зевран
отт: Отте
удовольствие: удовольствием
отвечать: отвечал
свободный: свободное
ухо: уши
армейский: армейское
вооружение: вооружение
экипировка: экипировку
знать: знает
абсолютно: абсолютно
ну: Ну
ведь: ведь
ни: ни
много: много
мало: мало
главный: главных
оружейник: оружейник
даже: даже
палец: пальцем
проткнуть: проткнул
воздух: воздух
над: над
важно: важно
объявить: объявил
должность: должность
правда: правда
мелко: мелко
затрястись: затрясся
засмеяться: засмеявшись
скрипучий: скрипучим
смех: смехом
удивить: Удивив
снова: снова
да: Да
удивляться: удивляться
громкий: громким
звание: званием
ж: ж
почему: почему
потому: потому
нет: нет
большой: большое
никто: никто
начальник: начальник
получаться: получается
зато: зато
самый: самый
вот: Вот
обвести: обвел
глаз: глазами
помещение: помещение
содержать: содержать
порядок: порядке
один: одну
сложный: сложного
дело: дело
махнуть: махнул
почти: почти
пользоваться: пользуется
готовить: готовим
штурмовик: штурмовиков
подобный: подобные
военный: военные
профессия: профессии
работа: работы
немного: немного
справляться: Справляюсь
позволить: Позвольте
согласиться: согласиться
оно: Оно
конечно: конечно
понятный: понятно
использоваться: используется
часть: частях
тоже: тоже
нужный: нужен
долгий: долгого
хранение: хранения
исправный: исправное
оружие: оружие
мочь: Может
прийти: пришл
негодность: негодность
думать: думаете
более: более
чем: чем
достаточно: достаточно
познание: познания
служить: Служил
больно: больно
молодой: молод
служивый: служивого
погодить: Погоди
лео: Лео
подтвердить: подтвержденные
опешив: опешив
являться: являюсь
настолько: настолько
популярный: популярным
пусть: пусть
брать: бери
голова: голову
старый: старый
знакомый: знакомый
рассказывать: рассказывал
черим: Черим
твой: твой
наставник: наставник
поведать: поведал
измываться: измываешься
товарищ: товарищами
группа: группе
заставлять: заставляя
сутки: сутки
напролет: напролт
вылезать: вылезать
из: из
обучать: обучающих
капсула: капсул
говорить: говорил
спортзал: спортзал
постоянно: постоянно
ходить: ходишь
факультативный: факультативно
время: времени
изучать: изучаю
основа: основы
рукопашка: рукопашки
пехотный: пехотного
бой: боя
гоняю: гоняю
чтобы: чтобы
отвлекаться: отвлекались
иногда: иногда
учеба: учбы
зачем: зачем
будущий: будущий
пилот: пилоты
набычиться: Набычился
другой: другой
мешать: мешать
ерепениться: ерепенься
против: против
просто: просто
обычно: обычно
пренебрегать: пренебрегают
знание: знаний
необычный: необычный
помощник: помощник
какой: Какой
теперь: Теперь
черед: черд
обыкновенный: обыкновенный
хотеть: хотел
помогать: помогать
база: базы
практический: практическим
опыт: опытом
намного: намного
лучше: лучше
тир: тир
иметься: имеется
проверять: проверять
пострелять: постреляю
заодно: заодно
хм: Хм
какойто: какойто
дикий: дикий
правильно: правильно
бал: Балах
сторона: стороны
обучение: обучения
профиль: профилю
то: то
помощь: Помощь
познакомиться: познакомились
знакомство: знакомство
произойти: произошла
третий: третий
день: дня
пора: пор
после: после
бежать: бежал
зев: Зеве
называть: называл
вместе: вместе
работать: работали
конец: конце
неделя: недели
незапланированный: незапланированная
встреча: встреча
ковырять: ковырял
очередной: очередную
штурмовой: штурмовую
винтовка: винтовку
нее: не
хрен: хрен
повести: повело
электромагнитный: электромагнитных
направлять: направляющих
открыться: открылась
дверь: дверь
войти: вошл
представлять: Представляем
внимание: вниманию
похожий: похожие
отобрать: отобрали
схожий: схожую
название: названию
смысл: смысле
литература: литературу
надежда: надежде
предоставить: предоставить
читатель: читателей
больше: больше
вариант: вариантов
интересный: интересные
обсуждение: Обсуждение
собственный: собственные
мнение: мнения
оставить: Оставьте
указать: Укажите
конкретно: конкретно
понравиться: понравилось
считать: считаете
