заголовок: Заголовок
олег: Олег
данильченко: Данильченко
имперский: Имперский
вояж: вояж
читать: читать
онлайн: онлайн
бесплатно: бесплатно
адрес: Адрес
здесь: здесь
быть: были
возможность: Возможность
весь: вс
текст: текст
электронный: электронной
книга: книге
совершенно: совершенно
целиком: целиком
полный: полную
версия: версию
в: в
некоторый: некоторых
случай: случае
присутствовать: присутствует
краткий: краткое
содержание: содержание
город: Город
м: М
спб: СПб
год: год
выпуск: выпуска
издательство: издательство
аста: АСТ
издательский: Издательский
дом: дом
ленинград: Ленинград
категория: категорию
боевой: Боевая
фантастика: фантастика
космический: Космическая
на: на
русский: русском
язык: языке
описание: описание
произведение: произведении
предисловие: предисловие
а: а
так: так
же: же
отзыв: отзывы
посетитель: посетителей
доступный: доступны
портал: портале
библиотека: Библиотека
либ: Либ
кат: Кат
создать: создана
для: для
любитель: любителей
полистать: полистать
хороший: хорошую
книжка: книжку
и: и
предлагать: предлагают
широкий: широкий
выбор: выбора
жанр: жанров
любовный: любовные
роман: романы
фэнтези: фэнтези
приключение: приключения
детектив: детективы
триллер: триллеры
эротика: эротика
документальный: документальные
научный: научные
юмористический: юмористические
анекдот: анекдоты
о: о
бизнес: бизнесе
проза: проза
детский: детские
сказка: сказки
религиия: религиии
новинка: новинки
православный: православные
старинный: старинные
про: про
компьютер: компьютеры
программирование: программирование
английский: английском
домоводство: домоводство
поэзия: поэзия
выбрав: Выбрав
по: по
душа: душе
вы: Вы
смочь: сможете
найти: нашли
действительно: действительно
стоить: стоящие
насладиться: насладиться
погружение: погружением
мир: мир
воображение: воображения
прочувствовать: прочувствовать
переживание: переживания
герой: героях
или: или
узнать: Узнайте
себя: себе
чтото: чтото
новый: новые
совершить: совершить
внутренний: внутреннее
открытие: открытие
подробный: Подробная
информация: информацию
ознакомление: ознакомления
текущий: текущему
запрос: запросу
представить: представлен
низкий: Ниже
к: к
чтение: чтение
аннотация: аннотацию
зависеть: зависит
от: от
тот: та
что: что
написать: напишите
сам: сам
автор: автора
если: если
не: не
необходимый: необходимую
комментарий: комментарии
мы: Мы
постараться: постараемся
отыскать: отыскать
она: она
кто: Кто
фамилия: фамилию
как: как
звать: зовут
список: списком
его: его
серия: сериям
уважаемые: Уважаемые
правообладатель: правообладатели
размещать: размещать
наш: нашем
сайт: сайте
у: у
любой: любых
зарегистрировать: зарегистрированного
пользователь: пользователя
ваш: ваши
опубликовать: опубликована
без: без
согласие: согласия
пожалуйста: пожалуйста
направить: направьте
жалоба: жалобу
заполните: заполните
форма: форму
обратный: обратной
связь: связи
течение: течение
час: часов
закрыть: закроем
доступ: доступ
нелегально: нелегально
разместить: размещенному
контент: контенту
разбить: разбитый
страница: страницу
система: Система
сохранение: сохранения
место: месте
последний: последней
прочитать: прочитанные
позволять: позволяет
с: с
удобство: удобством
необходимость: необходимости
каждый: каждый
раз: раз
заново: заново
искать: искать
остановиться: остановились
поставить: поставил
закладка: Закладка
момент: момент
перейти: перейти
который: которая
закончить: Закончив
шрифт: Шрифт
интервал: Интервал
только: только
илья: Илью
осмотр: осмотру
дверь: дверь
отъехать: отъехала
впустить: впустив
камера: камеру
очередной: очередной
дуболом: дуболом
принести: принесли
миска: миску
вручить: вручил
рука: руках
арестант: арестанту
отбыть: отбыл
восвояси: восвояси
оказаться: оказалось
зеленоватый: зеленоватая
масса: масса
вид: вид
консистенция: консистенции
гороховый: гороховый
суппюре: суппюре
вкус: вкус
пробовать: пробовал
когданибудь: когданибудь
чуть: чуть
подсолить: подсоленный
жидкий: жидкий
пластилин: пластилин
вот: вот
но: Но
бы: бы
такой: таких
существовать: существовал
вообще: вообще
природа: природе
то: то
мочь: может
иметь: имела
именно: именно
короче: Короче
мерзость: мерзость
надо: Надо
более: более
это: это
скорый: скорее
отрава: отрава
иначе: Иначе
тогда: тогда
какой: какие
смысл: смысле
лечить: лечат
этот: этот
бурдомес: бурдомес
нечего: нечем
прийтись: Пришлось
пить: пить
выпить: Выпив
удержать: удержав
стол: столе
завалиться: завалился
шконка: шконка
все: вс
обдумать: обдумать
переварить: Переварить
зеленый: Зелные
сопля: соплей
считать: считаете
пища: пищей
свой: своим
положение: положение
вопервых: Вопервых
размышлять: размышлял
илюха: Илюха
судить: судя
окружающий: окружающим
декорация: декорациям
я: я
дома: дома
земля: Земле
там: Там
технология: технологий
вроде: вроде
нет: нет
вовторых: Вовторых
похожий: похожие
из: из
один: один
плен: плена
угодить: угодил
следующий: следующий
песня: песне
матерный: матерной
ежик: Ежик
выпрыгнуть: выпрыгнул
окно: Окон
мордой: мордой
вляпаться: вляпался
говно: говно
очень: очень
втретьих: Втретьих
языковый: языковый
барьер: барьер
они: они
лопотать: лопочут
непонятный: непонятная
вчетвертых: Вчетвертых
пока: пока
грохнуть: грохнули
еще: ещ
значит: значит
нужный: нужен
значить: значит
пожить: поживем
ну: Ну
впятых: впятых
собственно: собственно
где: где
черт: чрт
взять: возьми
главное: главное
мля: мля
образ: образом
тут: Тут
нарисоваться: нарисовался
помнить: Помню
да: да
ни: ни
хрен: хрена
тащить: тащил
капитан: капитана
затем: затем
короткий: короткий
бой: бой
потом: потом
полено: поленом
затылок: затылку
аут: аут
далее: Далее
уже: уже
ночь: ночь
темный: темно
звезда: Звзды
луна: луны
ебинбобина: бинбобин
оно: оно
сразуто: Сразуто
сообразить: сообразил
бывать: бывают
всякий: всяком
обязанный: обязана
ответ: ответов
вопрос: вопросов
хотя: Хотя
понятный: понятно
теперь: теперь
уверенность: уверенность
знать: знать
стать: стала
ли: ли
легче: легче
уверенный: уверен
лучше: лучше
однако: Однако
рано: рано
поздно: поздно
ждать: ждать
уж: уж
ждатьто: ждатьто
уметь: умею
чех: чехи
научить: научили
глава: Глава
мысль: мыслями
он: ему
уснуть: уснул
жесткий: Жсткая
камерный: камерная
после: после
кавказский: кавказского
гостеприимство: гостеприимства
показаться: показалась
пуховый: пуховой
перина: периной
главный: главных
тепло: тепло
сухой: сухо
поэтому: Поэтому
сон: сон
спокойный: спокоен
ведь: ведь
близкий: ближайшее
время: времени
жизнь: жизни
ничто: ничто
грозить: грозит
можно: можно
поспать: поспать
солдат: солдат
спать: спать
везде: везде
условие: условиях
даже: даже
ход: ходу
караул: карауле
проснуться: Проснулся
голод: голод
понять: понял
сейчас: сейчас
сутки: суток
представляться: представлялось
возможный: возможным
странный: странный
свет: свет
происхождение: происхождения
выключаться: выключался
утро: утро
вечер: вечер
разница: разницы
никакой: никакой
подсказывать: подсказывает
пройти: прошло
мало: мало
решить: решил
пусть: пусть
потому: потому
ошибаться: ошибается
лично: лично
особый: особой
съесть: съесть
накануне: накануне
поход: походу
прекрасно: прекрасно
усвоились: усвоились
организм: организмом
требовать: требовал
добавка: добавки
хоть: хоть
желательно: желательно
большой: больше
тоска: тоской
посмотреть: посмотрел
вчера: вчера
кулинарный: кулинарный
изыск: изыск
удивиться: удивился
вместо: Вместо
нее: не
лежать: лежала
серый: серого
цвет: цвета
кашеобразный: кашеобразной
источать: источая
неприятный: неприятный
запашок: запашок
мерзко: мерзко
пузыриться: пузырясь
придача: придачу
таращиться: таращился
эксмиск: эксмиску
зажужжать: зажужжал
сервопривод: сервопривод
открывать: открывая
зайти: зашл
экземпляр: экземпляр
скафандр: скафандре
нести: неся
точный: точную
копия: копию
вчерашний: вчерашнюю
трапеза: трапезы
нормальный: нормальную
за: за
давешний: давешний
цветной: Цветной
лишний: лишних
разговор: разговоров
сразу: сразу
приступить: приступил
раненый: раненой
нога: ногу
прислушаться: прислушавшись
ощущение: ощущениям
удивление: удивлением
резкий: резкой
стрелять: стреляющей
боль: боли
верный: вернее
чтобы: чтобы
совсем: совсем
просто: просто
фоновый: фоновой
терпимый: терпимой
общий: общем
эскулап: Эскулап
межа: меж
сделать: сделал
приблуда: приблудой
прицепить: прицепил
отцепившись: отцепившись
остаться: осталась
видно: видно
сей: сей
чудоприбор: чудоприбор
потрудиться: потрудился
слава: славу
рана: Рана
выглядеть: выглядела
плохо: плохо
синюшный: синюшная
опухоль: опухоль
сойти: сошла
смениться: сменившись
вполне: вполне
пристойными: пристойными
розовый: розовыми
припухлость: припухлостями
хорошо: хорошо
заживать: заживающих
ранение: ранений
край: края
разрез: разреза
аккуратно: аккуратно
стянуть: стянуты
скобка: скобками
удовлетворенно: удовлетворенно
хрюкнуть: хрюкнул
приняться: принялся
обрабатывать: обрабатывать
колено: колено
какойто: какимито
препарат: препаратами
наложить: наложенного
компресс: компресс
перетянуть: перетянул
лента: лентой
затвердев: затвердев
продолжение: продолжением
гипс: гипса
тупо: тупо
проследить: проследив
взгляд: взглядом
нахмуриться: нахмурился
указать: Укажите
палец: пальцем
неприглядный: неприглядные
остаток: остатки
рот: рот
передернуть: передернуло
омерзение: омерзения
когда: когда
представлять: Представляем
внимание: вниманию
отобрать: отобрали
схожий: схожую
название: названию
литература: литературу
надежда: надежде
предоставить: предоставить
читатель: читателей
больше: больше
вариант: вариантов
интересный: интересные
обсуждение: Обсуждение
собственный: собственные
мнение: мнения
оставить: Оставьте
думать: думаете
конкретно: конкретно
понравиться: понравилось
почему: почему
