заголовок: Заголовок
олег: Олег
данильченко: Данильченко
имперский: Имперский
вояж: вояж
читать: читать
онлайн: онлайн
бесплатно: бесплатно
адрес: Адрес
здесь: Здесь
быть: будет
возможность: возможности
весь: вс
текст: текст
электронный: электронной
книга: книге
совершенно: совершенно
целиком: целиком
полный: полную
версия: версию
в: в
некоторый: некоторых
случай: случае
присутствовать: присутствует
краткий: краткое
содержание: содержание
город: Город
м: М
спб: СПб
год: Год
выпуск: выпуска
издательство: издательство
аста: АСТ
издательский: Издательский
дом: дом
ленинград: Ленинград
категория: категорию
боевой: Боевая
фантастика: фантастика
космический: Космическая
на: на
русский: русском
язык: языке
описание: описание
произведение: произведении
предисловие: предисловие
а: а
так: так
же: же
отзыв: отзывы
посетитель: посетителей
доступный: доступны
портал: портале
библиотека: Библиотека
либ: Либ
кат: Кат
создать: создана
для: для
любитель: любителей
полистать: полистать
хороший: Хорошо
книжка: книжку
и: и
предлагать: Предлагаем
широкий: широкий
выбор: выбора
жанр: жанров
любовный: любовные
роман: романы
фэнтези: фэнтези
приключение: приключения
детектив: детективы
триллер: триллеры
эротика: эротика
документальный: документальные
научный: научные
юмористический: юмористические
анекдот: анекдоты
о: о
бизнес: бизнесе
проза: проза
детский: детские
сказка: сказки
религиия: религиии
новинка: новинки
православный: православные
старинный: старинные
про: про
компьютер: компьютеры
программирование: программирование
английский: английском
домоводство: домоводство
поэзия: поэзия
выбрав: Выбрав
по: по
душа: душе
вы: Вы
смочь: сможете
найти: нашли
действительно: действительно
стоить: стоит
насладиться: насладиться
погружение: погружением
мир: мире
воображение: воображения
прочувствовать: прочувствовать
переживание: переживания
герой: героях
или: или
узнать: Узнайте
себя: себя
чтото: чтото
новый: новые
совершить: совершить
внутренний: внутреннее
открытие: открытие
подробный: Подробная
информация: информацию
ознакомление: ознакомления
текущий: текущему
запрос: запросу
представить: представлен
низкий: Ниже
к: к
чтение: чтение
аннотация: аннотацию
зависеть: зависит
от: от
тот: те
что: что
написать: напишите
сам: сам
автор: автора
если: Если
не: не
необходимый: необходимую
комментарий: комментарии
мы: Мы
постараться: постараемся
отыскать: отыскать
она: е
кто: кем
фамилия: фамилию
как: как
звать: зовут
список: списком
его: его
серия: сериям
уважаемые: Уважаемые
правообладатель: правообладатели
размещать: размещать
наш: наша
сайт: сайте
у: у
любой: любом
зарегистрировать: зарегистрированного
пользователь: пользователя
ваш: ваши
опубликовать: опубликована
без: без
согласие: согласия
пожалуйста: пожалуйста
направить: направьте
жалоба: жалобу
заполните: заполните
форма: форму
обратный: обратной
связь: связи
течение: течение
час: часов
закрыть: закроем
доступ: доступ
нелегально: нелегально
разместить: размещенному
контент: контенту
разбить: разбитый
страница: страницу
система: Система
сохранение: сохранения
место: места
последний: последней
прочитать: прочитанные
позволять: позволяет
с: с
удобство: удобством
необходимость: необходимости
каждый: КАЖДОГО
раз: раз
заново: заново
искать: искать
остановиться: остановились
поставить: Поставьте
закладка: Закладка
момент: момент
перейти: перейти
который: которого
закончить: Закончив
шрифт: Шрифт
интервал: Интервал
допустить: допустим
я: Я
утрясти: утрясу
вопрос: вопрос
освобождение: освобождением
но: Но
деньга: деньгами
это: этого
мантиец: мантийцу
равный: равно
ведь: ведь
нужный: нужными
где: где
он: им
они: Они
взять: возьмт
работа: работу
устраиваться: устраиваться
мелькать: Мелькать
тут: тут
уж: уж
больно: больно
заметный: заметен
попасться: Попадтся
глаз: глаза
свой: свою
бывший: бывшему
враг: врагу
тогда: тогда
завертеться: завертится
легко: легко
решать: решать
дать: дадите
опешить: опешил
док: док
да: Да
счет: счту
мой: моя
будущее: будущее
зарплата: зарплаты
слово: словом
приличный: приличной
наглец: Наглец
теперь: Теперь
прекрасно: прекрасно
понимать: понимаете
господин: господина
няга: Нягу
когда: Когда
поражаться: поражался
вопиющий: вопиющей
наглость: наглости
видимо: Видимо
подобный: подобным
способ: способом
вытрясти: вытрясли
имплантат: имплантат
сумма: сумму
пятьсот: пятьсот
тысяча: тысяч
однако: Однако
сделать: сделаю
просить: просите
молодой: молодой
человек: человек
уверить: уверены
за: за
потребовать: потребую
гораздо: гораздо
больше: больше
понадобиться: понадобится
согласный: согласны
такой: таким
условие: условия
просто: просто
помочь: помочь
бескорыстно: бескорыстно
помогать: Помогая
ничто: ничего
должный: должен
вот: вот
юноша: юноша
причем: причм
отказаться: отказаться
даааа: Даааа
както: както
забыть: забыл
медицина: медицина
только: только
второй: вторая
профессия: профессия
поделать: поделать
развести: Развел
рука: руку
грег: Грег
нет: нет
пролететь: пролетит
быстро: быстро
большой: большому
подопечный: подопечным
терять: терять
перспективный: перспективного
иметь: имею
право: права
даже: даже
прихоть: прихоть
требовать: требуют
интерес: интересы
империя: Империи
бы: бы
пафосно: пафосно
ни: ни
звучать: звучало
никогда: никогда
согласиться: соглашусь
поступить: поступить
служба: службу
б: Б
там: Там
несвободный: несвободен
неприемлемый: неприемлемо
ну: Ну
зачем: зачем
свобода: Свобода
сдаться: сдалась
подавлять: Подавляющее
большинство: большинство
жить: живм
радоваться: радуются
жизнь: Жизнь
заводить: Заводят
семья: семьи
растить: растят
ребенок: ребенок
более: более
никто: никто
свободный: свободен
ктото: ктото
связать: связан
контракт: контрактом
договор: договором
обязательство: обязательства
перед: перед
ктонибудь: кемнибудь
ты: ты
говорить: говорить
самто: Самто
эн: Эн
ди: Ди
тащить: тащишь
команда: команду
этот: этому
тоже: тоже
брать: бершь
моральный: моральные
судьба: судьбу
предположить: Предположим
уже: уже
выучиться: выучился
стать: стал
пилот: пилотом
корабль: корабль
экипаж: экипаж
нанять: наймшь
платить: платить
заработный: заработную
плата: плату
надеяться: Надеюсь
думать: думаете
заработать: заработать
кредит: кредиты
чтобы: чтобы
оплатить: оплатить
их: их
услуга: услуги
родиться: родившийся
изначально: изначально
потому: потому
мать: матери
какой: какой
идти: идти
речь: речь
общество: обществе
зависимый: зависим
иллюзия: иллюзия
пусть: Пусть
набычиться: Набычился
илюха: Илюха
хотеть: хочу
делать: делать
поступать: поступая
результат: результате
обеспечить: обеспеченная
достойный: достойная
близкие: близких
устраивать: устраивать
давать: давайте
договориться: Договорились
пока: пока
еще: ещ
вернуться: вернулся
разговор: разговор
обещать: обещаю
долг: долги
из: из
возвращать: возвращают
понять: Поймите
илио: Илио
обижаться: обижайтесь
редкий: редки
потенциал: потенциалом
скорый: скорее
помощь: помощь
сотрудничество: сотрудничество
взаимовыгодный: взаимовыгодным
один: Одно
сказать: скажу
точно: точно
наблюдать: наблюдать
успех: успехами
всегда: всегда
обратить: Обратите
внимание: вниманию
играть: играю
открыть: открыто
тори: Тори
направиться: направился
конвоир: конвоирам
уверенный: уверен
подумать: подумал
илья: Илье
безопасник: Безопасник
спросить: спросил
конвойный: конвойных
затем: Затем
отойти: отошл
сторона: сторону
пошевелить: пошевелил
губа: губами
при: при
эмоционально: эмоционально
жестикулируя: жестикулируя
общаться: общался
расстояние: расстоянии
начать: начал
снова: снова
втолковывать: втолковывать
полицейский: полицейскими
похоже: Похоже
получиться: получилось
доходчиво: доходчиво
вытянуться: вытянулись
стукнуть: стукнув
грудь: грудь
кулак: кулаком
правый: правой
земля: Земле
вскидывать: вскидывают
козырек: козырьку
головной: головного
убор: убора
отдавать: отдавая
честь: честь
незатейливый: незатейливо
обратиться: обратился
лицо: лице
маска: маска
обреченность: обреченности
смениться: сменилась
выражение: выражением
надежда: надежде
недоверие: недоверия
одновременно: одновременно
недолгий: Недолго
поговорить: поговорил
тыкать: тыкая
палец: пальцем
землянин: землянина
хлопнуть: хлопнув
плечо: плеча
правда: Правда
до: до
достать: достал
прийтись: пришлось
подпрыгнуть: подпрыгнуть
все: вс
уладить: уладил
мочь: можем
ждать: ждут
пойдемте: Пойдмте
двинуться: двинулись
далекий: дальше
коридор: коридорам
гигант: гигант
стоять: стоял
обращать: обращая
теребить: теребящих
смотреть: смотрел
вслед: вслед
глава: Глава
пропетляв: Пропетляв
минута: минут
десять: десять
прокатиться: прокатившись
несколько: нескольких
лифт: лифтах
наконец: наконец
вывести: вывел
выход: выходу
представлять: Представляем
похожий: похожие
отобрать: отобрали
схожий: схожую
название: названию
смысл: смысле
литература: литературу
предоставить: предоставить
читатель: читателей
вариант: вариантов
интересный: интересные
обсуждение: Обсуждение
собственный: собственные
мнение: мнения
оставить: Оставьте
главный: главных
указать: Укажите
конкретно: конкретно
понравиться: понравилось
почему: почему
считать: считаете
