заголовок: Заголовок
олег: Олег
данильченко: Данильченко
имперский: Имперский
вояж: вояж
читать: читать
онлайн: онлайн
бесплатно: бесплатно
адрес: Адрес
здесь: здесь
быть: есть
возможность: Возможность
весь: всей
текст: текст
электронный: электронной
книга: книге
совершенно: совершенно
целиком: целиком
полный: полную
версия: версию
в: в
некоторый: некоторых
случай: случаи
присутствовать: присутствует
краткий: краткое
содержание: содержание
город: Город
м: М
спб: СПб
год: год
выпуск: выпуска
издательство: издательство
аста: АСТ
издательский: Издательский
дом: дом
ленинград: Ленинград
категория: категорию
боевой: Боевая
фантастика: фантастика
космический: Космическая
на: на
русский: русском
язык: языке
описание: описание
произведение: произведении
предисловие: предисловие
а: а
так: так
же: же
отзыв: отзывы
посетитель: посетителей
доступный: доступны
портал: портале
библиотека: Библиотека
либ: Либ
кат: Кат
создать: создана
для: для
любитель: любителей
полистать: полистать
хороший: хорошую
книжка: книжку
и: и
предлагать: Предлагаем
широкий: широкий
выбор: выбора
жанр: жанров
любовный: любовные
роман: романы
фэнтези: фэнтези
приключение: приключения
детектив: детективы
триллер: триллеры
эротика: эротика
документальный: документальные
научный: научные
юмористический: юмористические
анекдот: анекдоты
о: о
бизнес: бизнесе
проза: проза
детский: детские
сказка: сказки
религиия: религиии
новинка: новинки
православный: православные
старинный: старинные
про: про
компьютер: компьютеры
программирование: программирование
английский: английском
домоводство: домоводство
поэзия: поэзия
выбрав: Выбрав
по: по
душа: душе
вы: Вы
смочь: смогли
найти: найдены
действительно: действительно
стоить: стоящие
насладиться: насладиться
погружение: погружением
мир: мир
воображение: воображения
прочувствовать: прочувствовать
переживание: переживания
герой: героях
или: или
узнать: Узнайте
себя: себя
чтото: чтото
новый: новые
совершить: совершить
внутренний: внутреннее
открытие: открытие
подробный: Подробная
информация: информацию
ознакомление: ознакомления
текущий: текущему
запрос: запросу
представить: представлен
низкий: Ниже
к: к
чтение: чтение
аннотация: аннотацию
зависеть: зависит
от: от
тот: тем
что: что
написать: напишите
сам: сам
автор: автора
если: если
не: не
необходимый: необходимо
комментарий: комментарии
мы: Мы
постараться: постараемся
отыскать: отыскать
она: ей
кто: кто
фамилия: фамилию
как: как
звать: зовут
список: списком
его: его
серия: сериям
уважаемые: Уважаемые
правообладатель: правообладатели
размещать: размещать
наш: нашем
сайт: сайте
у: у
любой: любой
зарегистрировать: зарегистрированного
пользователь: пользователя
ваш: ваши
опубликовать: опубликована
без: без
согласие: согласия
пожалуйста: пожалуйста
направить: направьте
жалоба: жалобу
заполните: заполните
форма: форму
обратный: обратной
связь: связи
течение: течение
час: часы
закрыть: закроем
доступ: доступ
нелегально: нелегально
разместить: размещенному
контент: контенту
разбить: разбитый
страница: страницу
система: системы
сохранение: сохранения
место: места
последний: последней
прочитать: прочитанные
позволять: позволяет
с: с
удобство: удобством
необходимость: необходимости
каждый: каждый
раз: раз
заново: заново
искать: искать
остановиться: остановились
поставить: Поставьте
закладка: Закладка
момент: момент
перейти: перейти
который: которая
закончить: закончили
шрифт: Шрифт
интервал: Интервал
различие: Различия
показаться: показались
илья: Илье
столь: столь
минимальный: минимальными
даже: даже
временной: временные
единица: единицы
время: время
он: он
переводить: переводил
привычный: привычные
минута: минуты
секунда: секунды
далее: далее
проще: проще
мера: меры
длина: длины
вес: веса
обозвать: обозвал
посвоему: посвоему
чтобы: чтобы
дальнейший: дальнейшем
путаться: путаться
другой: другие
гиперпереход: гиперпереходы
пошлопоехало: пошлопоехало
такой: таким
переход: переходы
парный: парные
находить: находили
действовать: действующие
врата: врата
значит: значит
пара: пара
они: они
находиться: находилась
надо: Надо
только: только
пройти: пройти
через: через
немаловажный: немаловажный
нюанс: нюанс
входить: входящие
гиперпортал: гиперпортал
самый: самым
активировать: активировать
корабль: корабль
становиться: становится
неуправляемый: неуправляемым
скорость: скорость
гиперпространство: гиперпространстве
отчегото: отчегото
неизменный: неизменна
однажды: однажды
гиперструна: гиперструну
ничто: ничего
поделать: поделать
большой: большое
нельзя: нельзя
неизменно: неизменно
достигнуть: достигнет
конец: конца
выйти: выйдет
притом: Притом
никак: никак
влиять: влияла
какой: какой
из: из
сторона: стороне
выходной: Выходная
всегда: всегда
одинаковый: одинакова
исключение: исключения
несмотря: несмотря
разница: разницу
тоннаж: тоннаже
когда: когда
недействующий: недействующие
удаваться: удавалось
неизвестный: неизвестным
причина: причине
возможно: Возможно
разрушить: разрушена
пропасть: пропавшие
хозяин: хозяева
достроить: достроили
спросить: спросить
теперь: теперь
уже: уже
общий: общими
просто: просто
пользоваться: пользуются
чудесный: чудесным
образ: образом
освоение: освоение
космос: космоса
начать: начали
развиваться: развиваться
стремительный: стремительными
темп: темпами
но: но
это: это
часто: часто
бывать: бывает
конфликт: конфликтов
между: между
заселенный: заселнные
обойтись: обошлось
сначала: сначала
локальный: локальные
стычка: стычки
перерасти: переросли
полноценный: полноценные
война: войну
уничтожение: уничтожение
то: То
смутный: смутные
пиратство: пиратство
грабеж: грабежи
рабство: рабство
процветать: процветало
пока: пока
найтись: нашелся
человек: люди
талантливый: талантливый
военачальник: военачальник
флот: флота
тогда: тогда
еще: ещ
планета: планеты
кадар: Кадар
убедить: убедил
лидер: лидеров
несколько: нескольких
соседний: соседних
объединение: объединения
выживание: выживания
впоследствии: Впоследствии
стать: стало
первый: первым
император: императором
центр: центром
вскоре: вскоре
принести: принесло
свой: своей
плод: плоды
появиться: появились
достаточно: достаточно
пространство: пространстве
можно: можно
безопасно: безопасно
жить: живут
торговать: торговать
остальной: остальных
исследовать: исследованные
территория: территории
состав: состав
образование: образованием
назвать: назвали
серый: Серой
зона: Зоной
фронтир: Фронтиром
обозначить: обозначив
граница: границы
куда: куда
соваться: соваться
следовать: следует
там: там
за: за
жизнь: жизни
человеческий: человеческую
никто: никто
ломаного: ломаного
грош: гроша
дать: дали
постепенно: Постепенно
видеть: видя
выгода: выгоду
присоединяться: присоединяться
расширять: расширяя
империя: Империи
где: где
господствовать: господствовали
процветание: процветание
однако: однако
образоваться: образовалась
параллельно: параллельно
простор: просторах
три: три
фигурант: фигуранта
верный: Вернее
два: два
государство: Государство
мара: Мар
республика: Республика
манти: Манти
также: также
основа: основе
иметь: имели
корень: корни
расселиться: расселившись
расовый: расовому
признак: признаку
преодолеть: преодолеть
древний: древних
разногласие: разногласия
постоянно: постоянно
воевать: воевали
представлять: Представляем
темнокожий: темнокожий
народ: народом
дико: дико
ненавидеть: ненавидели
светлый: светлый
кожа: кожи
мариец: Марийцы
хоть: хоть
оттенок: оттенок
являться: являлся
религиозный: религиозными
фанатик: фанатиками
их: их
единоверец: единоверцами
плюс: плюс
узаконить: узаконили
кадариец: Кадарийцы
многонациональный: многонациональным
перемешать: перемешаны
межнациональный: межнациональной
рознь: розни
никакой: никакого
смысл: смысле
бы: бы
наверно: наверно
далекий: дальше
б: б
политический: политической
арена: арене
возникнуть: возникли
веселый: веслые
ребята: ребята
под: под
самоназвание: самоназванием
элента: Эленте
элентийский: Элентийский
союз: союз
этот: этот
кулик: кулики
едва: едва
говорить: говоря
ни: ни
слово: слова
сразу: сразу
против: против
откуда: Откуда
взяться: взялись
понятный: понятно
потом: потом
выясниться: выяснилось
считать: считаете
потомок: потомками
построить: построили
отдать: отдать
должное: должное
технология: технологии
впечатляющий: впечатляющими
намного: намного
превосходить: превосходящими
существовать: существующие
объявиться: Объявись
ранний: пораньше
хан: хана
прийти: пришла
упустить: упущено
перед: Перед
противник: противником
бывший: бывшие
непримиримый: непримиримые
оппонент: оппоненты
таки: таки
договориться: договорились
усилие: усилиями
вломиля: вломили
высокомерный: высокомерным
выскочка: выскочкам
сопля: соплям
опомнившись: опомнившись
говориться: говорится
решить: решили
сохранить: сохранить
мина: мину
при: При
плохой: плохой
игра: игре
простой: Проще
пойти: пошли
диалог: диалог
какойто: какойто
делиться: делиться
нет: нет
подарить: подарили
оставаться: оставаясь
единоличный: единоличными
производитель: производителями
нейросеть: нейросети
медкапсула: медкапсулы
продление: продления
остаться: остались
высоко: выше
хотя: Хотя
внешне: внешне
сильно: сильно
отличаться: отличались
кстати: Кстати
один: одна
странность: странность
броситься: бросилась
глаз: глаза
многообразность: многообразности
вселенная: Вселенной
почемуто: почемуто
фигурировать: фигурируют
освоить: освоенном
земля: Земле
обычный: обычный
вид: виды
трудный: Трудно
понять: понять
почему: почему
оказаться: оказался
популярный: популярен
местный: местные
яйцеголовой: яйцеголовые
сей: сей
день: день
мочь: могут
ответить: ответить
вопрос: вопрос
да: да
встречаться: встречались
внимание: вниманию
похожий: похожие
отобрать: отобрали
схожий: схожую
название: названию
литература: литературу
надежда: надежде
предоставить: предоставить
читатель: читателей
больше: больше
вариант: вариантов
интересный: интересные
обсуждение: Обсуждение
собственный: собственные
мнение: мнения
оставить: Оставьте
думать: думаете
главный: главных
указать: Укажите
конкретно: конкретно
понравиться: понравилось
