заголовок: Заголовок
олег: Олег
данильченко: Данильченко
имперский: Имперский
вояж: вояж
читать: читать
онлайн: онлайн
бесплатно: бесплатно
адрес: Адрес
здесь: Здесь
быть: будет
возможность: Возможность
весь: вс
текст: текст
электронный: электронной
книга: книге
совершенно: совершенно
целиком: целиком
полный: полную
версия: версию
в: в
некоторый: некоторых
случай: случаях
присутствовать: присутствует
краткий: краткое
содержание: содержание
город: Город
м: М
спб: СПб
год: год
выпуск: выпуска
издательство: издательство
аста: АСТ
издательский: Издательский
дом: дом
ленинград: Ленинград
категория: категорию
боевой: Боевая
фантастика: фантастика
космический: Космическая
на: на
русский: русском
язык: языке
описание: описание
произведение: произведении
предисловие: предисловие
а: а
так: так
же: же
отзыв: отзывы
посетитель: посетителей
доступный: доступны
портал: портале
библиотека: Библиотека
либ: Либ
кат: Кат
создать: создана
для: для
любитель: любителей
полистать: полистать
хороший: хорошее
книжка: книжку
и: и
предлагать: предлагаю
широкий: широкий
выбор: выбора
жанр: жанров
любовный: любовные
роман: романы
фэнтези: фэнтези
приключение: приключения
детектив: детективы
триллер: триллеры
эротика: эротика
документальный: документальные
научный: научные
юмористический: юмористические
анекдот: анекдоты
о: о
бизнес: бизнесе
проза: проза
детский: детские
сказка: сказки
религиия: религиии
новинка: новинки
православный: православные
старинный: старинные
про: про
компьютер: компьютеры
программирование: программирование
английский: английском
домоводство: домоводство
поэзия: поэзия
выбрав: Выбрав
по: по
душа: душе
вы: Вы
смочь: сможете
найти: нашли
действительно: действительно
стоить: стоящие
насладиться: насладиться
погружение: погружением
мир: мир
воображение: воображения
прочувствовать: прочувствовать
переживание: переживания
герой: героях
или: или
узнать: узнав
себя: себя
чтото: Чтото
новый: новые
совершить: совершить
внутренний: внутреннее
открытие: открытие
подробный: Подробная
информация: информацию
ознакомление: ознакомления
текущий: текущему
запрос: запросу
представить: представлен
низкий: Ниже
к: к
чтение: чтение
аннотация: аннотацию
зависеть: зависит
от: от
тот: Тем
что: что
написать: напишите
сам: сами
автор: автора
если: если
не: не
необходимый: необходимую
комментарий: комментарии
мы: Мы
постараться: постараемся
отыскать: отыскать
она: ней
кто: кто
фамилия: фамилию
как: как
звать: зовут
список: списком
его: его
серия: сериям
уважаемые: Уважаемые
правообладатель: правообладатели
размещать: размещать
наш: наш
сайт: сайте
у: у
любой: любой
зарегистрировать: зарегистрированного
пользователь: пользователя
ваш: ваши
опубликовать: опубликована
без: без
согласие: согласия
пожалуйста: пожалуйста
направить: направьте
жалоба: жалобу
заполните: заполните
форма: форму
обратный: обратной
связь: связи
течение: течение
час: часов
закрыть: закроем
доступ: доступ
нелегально: нелегально
разместить: размещенному
контент: контенту
разбить: разбитый
страница: страницу
система: Система
сохранение: сохранения
место: места
последний: последней
прочитать: прочитанные
позволять: позволяет
с: с
удобство: удобством
необходимость: необходимости
каждый: каждый
раз: раз
заново: заново
искать: искать
остановиться: остановились
поставить: Поставьте
закладка: Закладка
момент: момент
перейти: перейти
который: который
закончить: закончили
шрифт: Шрифт
интервал: Интервал
я: Я
свободный: свободных
ветер: ветер
молодой: молодой
человек: человеке
но: Но
прежде: прежде
чем: чем
уйти: уйти
хотеть: хочу
сделать: сделал
предложение: предложение
опять: Опять
насторожиться: насторожился
илья: Илья
сказать: сказать
снова: снова
улыбнуться: Улыбнулся
бывший: бывший
док: док
отнеситесь: Отнеситесь
серьезность: серьзностью
такой: таким
часто: часто
услышать: услышишь
мочь: может
хватить: хватит
нагнетать: нагнетать
обстановка: обстановку
хорошо: хорошо
поднять: Поднял
рука: руку
извиняться: извиняющемся
жест: жесте
всегда: всегда
сразу: сразу
дело: дела
ну: Ну
ж: ж
думать: думаете
после: после
окончание: окончания
школа: школу
предложить: предложат
работа: работу
сб: СБ
бы: бы
это: это
доверие: доверие
илио: Илио
очень: очень
перспективный: перспективный
за: за
учитывать: учитывая
природный: природные
талант: таланты
да: да
экспериментальный: экспериментальную
модель: модель
сеть: сеть
аналог: аналогов
содружество: Содружестве
еще: ещ
иметься: имеется
скоро: скоро
начаться: начнтся
охота: охота
откуда: откуда
знать: знаете
забывать: забывайте
где: где
работать: работаю
до: до
конец: конца
откровенный: откровенным
то: то
спросить: спросить
учреждение: учреждении
устанавливать: устанавливали
поединок: поединок
просмотреть: просмотрел
запись: записи
породить: породил
куча: кучу
вопрос: вопрос
вот: Вот
поинтересоваться: поинтересовался
уж: Уж
изначально: изначально
обладать: обладали
потенциал: потенциалом
няга: Нягу
недолго: недолго
юлить: юлил
он: него
ничто: ничего
криминальный: криминального
поэтому: Поэтому
произойти: произошло
пойти: пошел
контакт: контакт
попросить: попросил
только: Только
распространяться: распространяться
какой: какой
сейчас: сейчас
характеристика: характеристики
честно: честно
интелект: Интелект
восприятие: восприятие
память: память
стать: стал
запираться: запираться
землянин: землянин
грег: Грег
присвистнуть: присвистнул
говорить: говорите
первый: первый
кандидат: кандидат
пристальный: пристальное
внимание: вниманию
сторона: стороны
петля: петель
сколько: сколько
семь: Семь
дааа: Дааа
ктонибудь: ктонибудь
удача: удача
понятие: понятия
равнозначный: равнозначные
издеваться: издеваетесь
никто: никто
другой: другое
мой: мо
история: историю
ладно: Ладно
вдаваться: вдаваться
подробность: подробности
попятный: попятную
насчет: насчт
скривиться: скривился
будто: будто
съесть: съел
три: три
лимон: лимона
судить: Судя
кислый: кислому
выражение: выражению
нет: нет
хотеться: хотелось
обидеть: обидеть
прекрасно: прекрасно
отношение: отношение
этот: этот
подобный: подобного
ожидать: ожидал
усмехнуться: усмехнулся
сбшник: СБшник
равный: равно
должный: должны
приготовить: приготовил
тоже: тоже
два: два
помнить: помню
второй: Второе
следующий: следующего
характер: характера
выплыло: выплыло
наружу: наружу
нечистоплотный: нечистоплотное
поведение: поведения
руководитель: руководителей
временной: временную
должность: должность
внештатный: внештатный
сотрудник: сотрудника
агент: агент
продолжить: продолжите
обучение: обучение
линия: линию
также: также
менять: менять
прийтись: придтся
идеально: идеально
подходить: подходит
некий: Некий
раздражитель: раздражителем
капитан: Капитана
например: например
взять: взять
хоть: хоть
желательныйто: желательното
прихлопнуть: прихлопнуть
разом: разом
вряд: Вряд
ли: ли
действовать: действует
собственный: собственные
инициатива: инициативе
скорый: Скорее
прикрывать: прикрывают
сверху: сверху
илюха: Илюхи
помяться: помялся
ответить: ответить
ввязываться: ввязываться
тори: Тори
правильно: правильно
оценить: оценил
сомнение: сомнения
подумать: подумать
крепко: КРЕПКО
многозначительный: многозначительно
пять: Пять
минута: минут
пока: пока
коечто: коечто
когда: Когда
отдать: отдать
причитаться: причитающийся
лоялитипоинт: лоялитипоинт
возможно: возможно
пригодиться: пригодится
иметь: имеет
расположение: расположение
оказаться: оказался
правый: прав
помочь: поможете
попасть: попав
беда: беду
получить: получили
помощь: помощь
теперь: Теперь
требоваться: требуется
при: при
предполагать: предполагает
неплохой: неплохое
вознаграждение: вознаграждение
вид: виде
ежемесячный: ежемесячного
жалование: жалованья
весьма: весьма
приличный: приличного
кстати: кстати
дать: дал
сорваться: сорваться
губа: губ
возражение: возражениям
помогать: помогая
свой: своего
друг: друзьям
господин: господина
бал: Балах
самый: самый
пытаться: пытается
прорваться: прорваться
нуждаться: нуждается
положительный: положительный
ответ: ответ
зачем: зачем
потребоваться: потребовался
ведь: Ведь
возвращаться: возвращаться
вина: вина
просто: просто
следить: следили
ситуация: ситуацией
нужный: нужный
резонный: Резонный
правило: правилам
внедрить: внедрены
среда: среду
учиться: учащихся
преподаватель: преподавателей
положенный: положено
вызвать: вызвать
подозрение: подозрения
юноша: юноша
уже: уже
более: более
находиться: находитесь
группа: группе
вернуть: Врни
давно: давно
зуб: зуб
удачно: удачно
складываться: складывается
решение: решение
согласный: согласен
подтверждать: подтверждаете
мнение: мнения
благоразумный: благоразумном
минутка: Минутку
там: там
непобедимый: Непобедимого
представлять: Представляем
похожий: похожие
отобрать: отобрали
схожий: схожую
название: названию
смысл: смысле
литература: литературу
надежда: надежде
предоставить: предоставить
читатель: читателей
больше: больше
вариант: вариантов
интересный: интересные
обсуждение: Обсуждение
оставить: Оставьте
главный: главных
указать: Укажите
конкретно: конкретно
понравиться: понравилось
почему: почему
считать: считаете
