заголовок: Заголовок
олег: Олег
данильченко: Данильченко
имперский: Имперский
вояж: вояж
читать: читать
онлайн: онлайн
бесплатно: бесплатно
адрес: Адрес
здесь: здесь
быть: будет
возможность: возможность
весь: вс
текст: текст
электронный: электронной
книга: книге
совершенно: совершенно
целиком: целиком
полный: полное
версия: версию
в: в
некоторый: некоторое
случай: случае
присутствовать: присутствует
краткий: краткое
содержание: содержание
город: Город
м: М
спб: СПб
год: лет
выпуск: выпуска
издательство: издательство
аста: АСТ
издательский: Издательский
дом: дом
ленинград: Ленинград
категория: категорию
боевой: боевыми
фантастика: фантастика
космический: Космическая
на: на
русский: русском
язык: языке
описание: описание
произведение: произведении
предисловие: предисловие
а: а
так: так
же: же
отзыв: отзывы
посетитель: посетителей
доступный: доступны
портал: портале
библиотека: Библиотека
либ: Либ
кат: Кат
создать: создать
для: для
любитель: любителей
полистать: полистать
хороший: Хорошо
книжка: книжку
и: и
предлагать: Предлагаем
широкий: широкий
выбор: выбора
жанр: жанров
любовный: любовные
роман: романы
фэнтези: фэнтези
приключение: приключения
детектив: детективы
триллер: триллеры
эротика: эротика
документальный: документальные
научный: научные
юмористический: юмористические
анекдот: анекдоты
о: о
бизнес: бизнесе
проза: проза
детский: детские
сказка: сказки
религиия: религиии
новинка: новинки
православный: православные
старинный: старинные
про: про
компьютер: компьютеры
программирование: программирование
английский: английском
домоводство: домоводство
поэзия: поэзия
выбрав: Выбрав
по: по
душа: душе
вы: Вы
смочь: смогу
найти: нашли
действительно: действительно
стоить: стоящие
насладиться: насладиться
погружение: погружением
мир: мир
воображение: воображения
прочувствовать: прочувствовать
переживание: переживания
герой: героях
или: или
узнать: Узнайте
себя: себя
чтото: чтото
новый: новые
совершить: совершить
внутренний: внутренних
открытие: открытие
подробный: Подробная
информация: информацию
ознакомление: ознакомления
текущий: текущему
запрос: запросу
представить: представлен
низкий: Ниже
к: к
чтение: чтение
аннотация: аннотацию
зависеть: зависит
от: от
тот: того
что: что
написать: напишите
сам: сам
автор: автора
если: Если
не: не
необходимый: необходимую
комментарий: комментарии
мы: Мы
постараться: постараемся
отыскать: отыскать
она: она
кто: кто
фамилия: фамилию
как: как
звать: зовут
список: списком
его: его
серия: сериям
уважаемые: Уважаемые
правообладатель: правообладатели
размещать: размещать
наш: наши
сайт: сайте
у: у
любой: любых
зарегистрировать: зарегистрированного
пользователь: пользователя
ваш: ваши
опубликовать: опубликована
без: без
согласие: согласия
пожалуйста: пожалуйста
направить: направьте
жалоба: жалобу
заполните: заполните
форма: форму
обратный: обратной
связь: связи
течение: течение
час: часов
закрыть: закроем
доступ: доступ
нелегально: нелегально
разместить: размещенному
контент: контенту
разбить: разбитый
страница: страницу
система: Система
сохранение: сохранения
место: места
последний: последних
прочитать: прочитанные
позволять: позволяет
с: с
удобство: удобством
необходимость: необходимости
каждый: каждый
раз: раза
заново: заново
искать: искать
остановиться: остановились
поставить: Поставьте
закладка: Закладка
момент: момент
перейти: перейти
который: которые
закончить: закончен
шрифт: Шрифт
интервал: Интервал
илья: Илья
еще: ещ
удобнее: удобнее
устроиться: устроился
кресло: кресле
отпить: отпил
уже: уже
теплый: теплого
сок: соком
скривиться: скривился
намекать: намекая
няга: Нягу
помешать: помешало
бы: бы
поменять: поменять
понять: понял
правильно: правильно
отреагировать: отреагировал
адекватно: адекватно
пуля: пулей
метнувшись: метнувшись
соседний: соседнюю
комната: комнату
притаранить: притаранив
стакан: стакан
илюха: Илюха
скептически: скептически
оглядеть: оглядел
осторожно: осторожно
попробовать: попробовал
потом: потом
удовлетворенно: удовлетворенно
кивнуть: кивнул
плотоядный: плотоядным
взгляд: взглядом
посмотреть: посмотрел
растерять: растерянного
мужчина: мужчину
теперь: теперь
передернуло: передернуло
он: он
поход: походу
сморозить: сморозил
глупость: глупость
рассказать: расскажу
насколько: насколько
важный: важен
данный: данный
ну: ну
рассказывать: рассказывайте
там: там
за: за
проблема: проблема
я: я
подумать: подумаю
помочь: помочь
наглый: наглой
улыбка: улыбкой
произнести: произнс
глава: Глава
видно: видно
злиться: злится
большой: больше
конечно: конечно
но: Но
свой: свои
наглость: наглостью
явно: явно
тоже: тоже
разозлить: разозлил
однако: однако
справиться: справился
эмоция: эмоциями
взять: взял
рука: руках
только: только
должный: должна
понимать: понимать
секретный: секретная
прежде: прежде
чем: чем
начать: начну
дать: дать
официальный: официальное
стоп: Стоп
грубо: грубо
прервать: прервал
поток: поток
слово: словах
даже: даже
прихлопнуть: прихлопнул
ладонь: ладонью
стол: столу
убедительность: убедительности
ни: Ни
собираться: собираюсь
заранее: заранее
давать: давайте
хотя: хотя
буквально: буквально
всего: всего
пара: пару
назад: назад
принять: принял
гражданство: гражданство
империя: Империи
настолько: настолько
дикарь: дикарь
хотеться: хотелось
это: этом
либо: либо
играть: играете
открытый: открытую
заканчивать: заканчиваем
диалог: диалог
начинать: начинаем
заниматься: заниматься
выбрать: выбранной
нейросеть: нейросетей
решение: решение
задуматься: задумался
нем: нм
бороться: борются
два: два
противоречивый: противоречивых
желание: желания
очень: очень
выгнать: выгнать
пинок: пинками
из: из
кабинет: кабинете
этот: этих
обнаглеть: обнаглевшего
клиент: клиента
время: время
вынудить: вынужден
уговаривать: уговаривать
остаться: остаться
через: Через
наконец: наконец
решиться: решился
повашему: повашему
обещать: обещать
под: под
протокол: протокол
сейчас: сейчас
выйти: вышли
стена: стены
мочь: может
сделать: сделать
согласиться: соглашусь
далекий: дальше
лео: Лео
гражданин: гражданин
кадар: Кадар
ясный: ясном
ум: уме
твердый: тврдой
память: памяти
какойлибо: какоголибо
давление: давления
сторона: стороны
заявлять: заявляю
услышать: услышу
подлежать: подлежит
разглашение: разглашению
невыполнение: невыполнения
требование: требований
господин: господин
заключаться: заключается
соглашение: соглашение
иметь: имеет
право: право
применять: применять
санкция: санкции
ранний: раньше
получить: получат
вступать: вступает
сила: силу
после: после
мой: моим
отказ: отказа
дальнейший: дальнейшем
сотрудничество: сотрудничестве
пойти: пойдт
хотеть: хотел
вздохнуть: вздохнул
приемлемый: приемлемо
вот: Вот
чудненький: чудненько
улыбнуться: улыбнулся
то: то
ждать: ждут
ведь: Ведь
давно: давно
дело: деле
более: более
принцип: принципе
разница: разницы
ктолибо: комулибо
нет: нет
приступить: приступим
группа: группа
ученый: ученых
руководство: руководством
разработать: разработала
поколение: поколений
прорыв: прорыв
улучшать: улучшать
характеристика: характеристики
интеллект: интеллект
обычно: обычно
происходить: происходит
при: при
активация: активации
остальной: остальные
фигурировать: фигурируют
карта: картах
фпи: ФПИ
кроме: Кроме
расчет: расчетам
поднимать: поднимать
минимум: минимум
пятьдесят: пятьдесят
пункт: пунктов
также: также
нее: не
заложить: заложена
функция: функция
укрепление: укрепления
кость: костей
связка: связок
мышца: мышц
улучшение: улучшения
общий: общего
состояние: состояния
организм: организма
использование: использования
имплантат: имплантатов
значить: значит
человек: человек
установка: установки
такой: такой
сеть: сеть
отличаться: отличаться
напичкать: напичкан
военный: военных
образец: образец
сохраняться: сохраняется
сказать: сказать
рассчитать: рассчитано
верный: верно
шесть: шесть
петля: петель
целый: целых
восемь: восемь
естественный: Естественно
объем: объемы
носитель: носителей
увеличить: увеличены
полтора: полтора
показатель: показателей
модель: моделей
быстродействие: быстродействие
соответственно: соответственно
точно: точно
знать: знаем
эксперимент: эксперимент
думать: думаете
медленный: медленнее
намного: намного
быстрый: быстрее
уважаемый: Уважаемый
звучать: звучит
просто: просто
потрясающе: потрясающе
равный: равно
непонятный: непонятно
зачем: зачем
иметься: имеется
шедевр: шедевр
выглядеть: выглядит
пока: пока
сожаление: сожалению
радужный: радужно
параллельно: параллельно
другой: другие
команда: команды
вести: ведут
разработка: разработки
независящий: независящим
причина: причинам
задержаться: задержались
несколько: несколько
отдельный: отдельная
история: история
касаться: касается
лучше: лучше
испытание: испытаний
пройти: пройдут
успешно: успешно
задокументировать: задокументированных
результат: результатов
нужный: Нужен
доброволец: доброволец
между: между
конкурент: конкуренты
финишный: финишную
прямая: прямую
они: они
успеть: успели
заявить: заявить
куратор: кураторам
элентийский: Элентийского
союз: союза
наплевать: наплевать
трудность: трудности
транш: транш
продолжение: продолжение
исследование: исследований
запуск: запуск
производство: производства
утереться: утрмся
изъять: изъято
перевести: переведут
куданибудь: куданибудь
периферия: периферию
копировать: копировать
устареть: устаревшие
база: базы
знание: знаний
представлять: Представляем
внимание: вниманию
похожий: похожие
отобрать: отобрали
схожий: схожую
название: названию
смысл: смысле
литература: литературу
надежда: надежде
предоставить: предоставить
читатель: читателей
больше: больше
вариант: вариантов
интересный: интересные
обсуждение: Обсуждение
собственный: собственные
мнение: мнения
оставить: Оставьте
главный: главных
указать: Укажите
конкретно: конкретно
понравиться: понравилось
почему: почему
считать: считаете
