заголовок: Заголовок
олег: Олег
данильченко: Данильченко
имперский: Имперский
вояж: вояж
читать: читать
онлайн: онлайн
бесплатно: бесплатно
адрес: Адрес
здесь: Здесь
быть: буду
возможность: Возможность
весь: вс
текст: текст
электронный: электронной
книга: книге
совершенно: совершенно
целиком: целиком
полный: полную
версия: версию
в: в
некоторый: некоторых
случай: случаях
присутствовать: присутствует
краткий: краткое
содержание: содержание
город: Город
м: М
спб: СПб
год: год
выпуск: выпуска
издательство: издательство
аста: АСТ
издательский: Издательский
дом: дом
ленинград: Ленинград
категория: категорию
боевой: Боевая
фантастика: фантастика
космический: Космическая
на: на
русский: русского
язык: языка
описание: описание
произведение: произведении
предисловие: предисловие
а: а
так: так
же: же
отзыв: отзывы
посетитель: посетителю
доступный: доступные
портал: портале
библиотека: Библиотека
либ: Либ
кат: Кат
создать: создана
для: для
любитель: любителей
полистать: полистать
хороший: хорошую
книжка: книжку
и: и
предлагать: Предлагаем
широкий: широкий
выбор: выбора
жанр: жанров
любовный: любовные
роман: романы
фэнтези: фэнтези
приключение: приключения
детектив: детективы
триллер: триллеры
эротика: эротика
документальный: документальные
научный: научные
юмористический: юмористические
анекдот: анекдоты
о: о
бизнес: бизнесе
проза: проза
детский: детские
сказка: сказки
религиия: религиии
новинка: новинки
православный: православные
старинный: старинные
про: про
компьютер: компьютера
программирование: программирование
английский: английском
домоводство: домоводство
поэзия: поэзия
выбрав: Выбрав
по: по
душа: душе
вы: Вы
смочь: сможет
найти: нашли
действительно: действительно
стоить: стоящие
насладиться: насладиться
погружение: погружением
мир: мир
воображение: воображения
прочувствовать: прочувствовать
переживание: переживания
герой: героях
или: или
узнать: Узнайте
себя: себе
чтото: чтото
новый: новые
совершить: совершить
внутренний: внутреннее
открытие: открытие
подробный: Подробная
информация: информацию
ознакомление: ознакомления
текущий: текущему
запрос: запросу
представить: представлен
низкий: Ниже
к: к
чтение: чтение
аннотация: аннотацию
зависеть: зависит
от: от
тот: Тот
что: что
написать: напишите
сам: сам
автор: автора
если: если
не: не
необходимый: необходимо
комментарий: комментарии
мы: Мы
постараться: постараемся
отыскать: отыскать
она: е
кто: Кто
фамилия: фамилию
как: как
звать: зовут
список: списком
его: его
серия: сериям
уважаемые: Уважаемые
правообладатель: правообладатели
размещать: размещать
наш: нашем
сайт: сайте
у: у
любой: любые
зарегистрировать: зарегистрированного
пользователь: пользователя
ваш: ваши
опубликовать: опубликована
без: без
согласие: согласия
пожалуйста: пожалуйста
направить: направьте
жалоба: жалобу
заполните: заполните
форма: форму
обратный: обратной
связь: связи
течение: течение
час: часов
закрыть: закрыл
доступ: доступ
нелегально: нелегально
разместить: размещенному
контент: контенту
разбить: разбитый
страница: страницу
система: Система
сохранение: сохранения
место: места
последний: последний
прочитать: прочитанные
позволять: позволял
с: с
удобство: удобством
необходимость: необходимости
каждый: каждый
раз: раз
заново: заново
искать: искал
остановиться: остановились
поставить: Поставьте
закладка: Закладка
момент: момент
перейти: перейти
который: которые
закончить: закончили
шрифт: Шрифт
интервал: Интервал
разгон: разгон
разуметься: Разумеется
готовый: готовы
добавить: добавить
еще: ещ
восемь: восемь
тысяча: тысяч
то: то
бонус: бонусы
пойти: пойдут
общий: общие
база: базе
знание: знаний
ну: ну
за: за
совсем: совсем
отдельный: отдельную
плата: плату
предоставить: предоставить
легально: легально
профильный: профильные
очень: очень
нет: нет
спасибо: спасибо
требоваться: требуется
пока: пока
я: мне
собираться: собираясь
проходить: проходить
обучение: обучение
войсковой: войсковой
резерв: резерва
там: там
думать: думаете
получить: получу
замечательный: Замечательно
значить: Значит
получаться: получается
начать: начал
подводить: подводить
итог: итог
менеджер: менеджер
сеть: сеть
пилот: Пилот
муэлит: МУЭлит
это: это
шестьдесят: шестьдесят
четыре: четыре
плюс: плюс
нее: не
итого: итого
семьдесят: семьдесят
два: две
он: ему
успеть: успел
договорить: договорить
вдруг: вдруг
открыться: открылась
дверь: дверь
пропустить: пропустила
внутрь: внутрь
кабинет: кабинета
запыхаться: запыхавшегося
толстячок: толстячка
невысокий: невысокого
рост: роста
раскраснеться: раскрасневшимся
лицо: лицом
крайне: крайне
возбудить: возбужднного
господин: господин
няга: Нягу
проблема: проблем
илья: Илья
улыбнуться: улыбнулся
вспомнить: вспомнив
фильм: фильм
бриллиантовый: Бриллиантовая
рука: руками
шеф: Шеф
пропасть: пропало
илюхачуть: Илюхачуть
расхохотаться: расхохотался
настолько: Настолько
похожий: похожие
комичный: комичной
выглядеть: выглядела
ситуация: ситуация
особенно: особенно
исполнение: исполнении
появиться: появился
персонаж: персонажа
тихо: Тихо
пуха: Пухи
ты: Ты
разве: разве
видеть: видя
услышать: Услышав
имя: имя
войти: вошедшего
чуть: чуть
заржать: заржал
голос: голос
просто: просто
точка: точку
правда: правда
относительно: относительно
но: Но
менее: менее
илюха: Илюха
еле: еле
сдержаться: сдержался
утирать: утирая
выступить: выступившие
слеза: слезы
недовольный: недовольно
зыркнуть: зыркнул
упорно: упорно
продолжать: продолжал
стоять: стоять
желать: желая
покинуть: покинуть
помещение: помещение
тяжело: тяжело
многозначительно: многозначительно
вздохнуть: вздохнул
бы: бы
говорить: говорил
ох: Ох
уж: уж
этот: этот
сотрудник: сотрудники
ничто: ничего
мочь: можете
обратиться: обратился
извинить: Извините
видимо: видимо
срочно: срочно
подождать: подождать
занять: займет
много: много
время: времени
минута: минут
пять: пять
более: более
да: Да
спешить: спешу
решать: решать
свой: свои
вопрос: вопросов
ответить: ответил
выйти: вышел
тут: тут
закрыться: закрылась
отсечь: отсекла
звук: звуки
происходить: происходило
слышать: слышал
решение: решение
затянуться: затянулось
эдак: эдак
полчаса: полчаса
уложиться: уложились
эскулап: эскулапа
наконец: Наконец
оглядеть: оглядел
снизу: снизу
вверх: вверх
сказать: сказал
невнятно: невнятно
наподобие: наподобие
проходите: проходите
затем: затем
чухнуть: чухнул
коридор: коридору
бормотать: бормоча
под: под
нос: нос
заставить: заставил
ждать: ждать
приносить: приносим
глубокий: глубочайшие
извинение: извинения
задержка: задержку
такой: Такими
слово: словами
встретить: встретил
дело: дело
важный: важным
присаживайтесь: Присаживайтесь
продолжить: продолжим
сесть: сел
закинуть: закинул
нога: ногу
уставиться: уставился
ожидание: ожидании
продолжение: продолжения
разговор: разговора
между: между
судорожно: судорожно
файл: файлах
голографический: голографический
монитор: монитор
возникнуть: возник
прямо: прямо
перед: перед
воздух: воздухе
видно: видно
делать: делал
хоть: хоть
почти: почти
прозрачный: прозрачным
однако: однако
случайный: случайному
положенный: положено
меж: меж
ковыряться: ковыряться
вид: вид
расстроить: расстроен
растерять: растерянного
опять: опять
забыть: забыл
клиент: клиента
решить: решил
мешать: мешать
человек: людей
прошествие: прошествии
десять: десяти
оно: нем
вспоминать: вспоминать
кашлянуть: кашлянул
дабы: дабы
привлечь: привлечь
внимание: вниманию
аж: аж
вздрогнуть: вздрогнул
поглотить: поглощн
мысль: мысли
медик: Медик
растерянно: растерянно
глянуть: глянул
уже: уже
снова: снова
извиняться: извиняться
замереть: замер
открыть: открытым
рот: ртом
потом: потом
задумчивый: задумчиво
оценивающе: оценивающе
сверлить: сверлить
взгляд: взглядом
парень: парня
даже: даже
стать: стало
зловещий: зловещим
показаться: показался
знать: знаете
уважаемый: уважаемый
лео: Лео
непобедимый: Непобедимом
оставить: Оставьте
присвоить: присвоили
пират: пираты
общийто: общемто
грег: Грег
настоять: настоял
идеальный: идеальный
вариант: вариантов
рамка: рамках
империя: Империи
ведь: Ведь
помочь: помогли
вот: Вот
номер: номер
усмехнуться: усмехнулся
прийти: пришел
чтобы: чтобы
вместо: вместо
помогать: помогать
обязанный: обязаны
послушать: послушайте
шанс: шанс
согласиться: согласитесь
результат: Результаты
пятидесятилетний: пятидесятилетних
исследование: исследований
пропадут: пропадут
работа: работ
сотня: сотен
трудиться: трудились
над: над
проект: проектом
называться: называется
остап: Остапа
понести: понесло
понять: понял
выдурить: выдурить
яйцеголов: яйцеголовых
серьезный: серьзные
лошара: лошара
проговориться: проговорился
они: им
пипец: пипец
надо: надо
сначала: сначала
далекий: дальше
выгодный: выгодно
удобнее: удобнее
устроиться: устроился
кресло: кресле
отпить: отпил
теплый: теплого
сок: соком
скривиться: скривился
намекать: намекая
помешать: помешало
поменять: поменять
правильно: правильно
отреагировать: отреагировал
адекватно: адекватно
пуля: пулей
метнувшись: метнувшись
соседний: соседнюю
комната: комнату
притаранить: притаранив
стакан: стакан
скептически: скептически
осторожно: осторожно
попробовать: попробовал
удовлетворенно: удовлетворенно
кивнуть: кивнул
плотоядный: плотоядным
посмотреть: посмотрел
мужчина: мужчину
представлять: Представляем
отобрать: отобрали
схожий: схожую
название: названию
смысл: смысле
литература: литературу
надежда: надежде
читатель: читателей
больше: больше
интересный: интересные
обсуждение: Обсуждение
собственный: собственные
мнение: мнения
главный: главных
указать: Укажите
конкретно: конкретно
понравиться: понравилось
почему: почему
считать: считаете
