заголовок: Заголовок
олег: Олег
данильченко: Данильченко
имперский: Имперский
вояж: вояж
читать: читать
онлайн: онлайн
бесплатно: бесплатно
адрес: Адрес
здесь: Здесь
быть: было
возможность: возможности
весь: все
текст: текст
электронный: электронной
книга: книге
совершенно: совершенно
целиком: целиком
полный: полной
версия: версию
в: в
некоторый: некоторых
случай: случаях
присутствовать: присутствует
краткий: краткое
содержание: содержание
город: городами
м: М
спб: СПб
год: год
выпуск: выпуска
издательство: издательство
аста: АСТ
издательский: Издательский
дом: дом
ленинград: Ленинград
категория: категорию
боевой: боевого
фантастика: фантастика
космический: Космическая
на: на
русский: русском
язык: языке
описание: описание
произведение: произведении
предисловие: предисловие
а: а
так: так
же: же
отзыв: отзывы
посетитель: посетителей
доступный: доступны
портал: портале
библиотека: Библиотека
либ: Либ
кат: Кат
создать: создана
для: для
любитель: любителей
полистать: полистать
хороший: Хорошо
книжка: книжку
и: и
предлагать: Предлагаем
широкий: широкий
выбор: выбора
жанр: жанров
любовный: любовные
роман: романы
фэнтези: фэнтези
приключение: приключения
детектив: детективы
триллер: триллеры
эротика: эротика
документальный: документальные
научный: научные
юмористический: юмористические
анекдот: анекдоты
о: о
бизнес: бизнесе
проза: проза
детский: детские
сказка: сказки
религиия: религиии
новинка: новинки
православный: православные
старинный: старинные
про: про
компьютер: компьютеры
программирование: программирование
английский: английском
домоводство: домоводство
поэзия: поэзия
выбрав: Выбрав
по: по
душа: душе
вы: Вы
смочь: сможешь
найти: Найди
действительно: действительно
стоить: стоящие
насладиться: насладиться
погружение: погружением
мир: мир
воображение: воображения
прочувствовать: прочувствовать
переживание: переживания
герой: героях
или: или
узнать: узнать
себя: себя
чтото: чтото
новый: новые
совершить: совершить
внутренний: внутреннее
открытие: открытие
подробный: Подробная
информация: информацию
ознакомление: ознакомления
текущий: текущему
запрос: запросу
представить: представлен
низкий: Ниже
к: к
чтение: чтение
аннотация: аннотацию
зависеть: зависит
от: от
тот: теми
что: что
написать: напишите
сам: сам
автор: автора
если: Если
не: не
необходимый: необходимую
комментарий: комментарии
мы: Мы
постараться: постараемся
отыскать: отыскать
она: она
кто: Кто
фамилия: фамилию
как: как
звать: зовут
список: списком
его: его
серия: сериям
уважаемые: Уважаемые
правообладатель: правообладатели
размещать: размещать
наш: нашем
сайт: сайте
у: у
любой: любой
зарегистрировать: зарегистрированного
пользователь: пользователя
ваш: ваши
опубликовать: опубликована
без: без
согласие: согласия
пожалуйста: пожалуйста
направить: направьте
жалоба: жалобу
заполните: заполните
форма: форму
обратный: обратной
связь: связи
течение: течение
час: часов
закрыть: закрыты
доступ: доступ
нелегально: нелегально
разместить: размещенному
контент: контенту
разбить: разбитый
страница: страницу
система: Система
сохранение: сохранения
место: места
последний: последней
прочитать: прочитанные
позволять: позволяет
с: с
удобство: удобством
необходимость: необходимости
каждый: каждый
раз: раз
заново: заново
искать: искать
остановиться: остановились
поставить: поставил
закладка: Закладка
момент: момент
перейти: перейти
который: который
закончить: закончил
шрифт: Шрифт
интервал: Интервал
девушка: Девушка
хотеть: хотела
съязвить: съязвить
ответ: ответ
но: Но
успеть: успела
открыться: Открывшиеся
дверь: Дверь
возвестить: возвестили
пора: пора
выходить: выходить
арена: арену
гладиатор: гладиаторы
подумать: подумал
илюха: Илюха
включать: Включаем
радар: радары
скомандовать: скомандовал
он: он
вслух: вслух
один: Один
взгляд: взгляда
полигон: полигон
хватить: хватило
чтобы: чтобы
напряжение: напряжение
спасть: спало
это: это
участок: участок
какойто: Какието
воссоздать: воссозданный
искином: ИскИном
нет: нет
конечно: конечно
ничто: ничего
общий: общего
земной: земными
скорый: скорее
рабочий: рабочий
городок: городок
какойнибудь: какойнибудь
безжизненный: безжизненной
планета: планеты
где: где
обосноваться: обосновались
шахтер: шахтеры
за: за
экология: экологию
можно: можно
переживать: переживать
металлический: металлические
конструкция: Конструкции
трубопровод: трубопроводы
стальной: стальные
опора: опоры
переходный: переходные
тоннель: тоннели
сделать: сделал
из: из
прозрачный: прозрачного
материал: материала
непонятный: непонятного
назначение: назначения
окружать: окружали
сторона: сторону
сломать: сломано
перекручено: перекручено
взрыв: взрывами
раздавлено: раздавлено
разрушить: разрушено
отовсюду: Отовсюду
подниматься: поднимались
столб: столбы
густой: густого
дым: дыма
чисто: Чисто
военный: военный
пейзаж: пейзажа
через: через
команда: команда
выбраться: выбралась
закрыться: закрылась
пропасть: пропала
посмотреть: посмотреть
стена: стены
находиться: находилась
то: то
увидеть: увидеть
продолжение: продолжение
только: Только
подойти: подойдя
вплотную: вплотную
дотронувшись: дотронувшись
рука: рукой
понять: Понял
просто: просто
изображение: изображения
транслировать: транслируемое
извне: извне
настолько: Настолько
иллюзия: иллюзия
перспектива: перспектива
сориентировавшись: Сориентировавшись
местность: местность
землянин: землянин
начать: начал
действовать: действовать
красный: Красный
три: Три
видеть: Вижу
камень: камни
справа: справа
да: да
лезть: лезь
они: они
твой: твой
задача: задача
дать: дать
никто: никому
там: там
пройти: пройти
пискнуть: пискнул
голос: голос
ли: ли
рилла: Риллы
милла: Миллы
илья: Илья
ну: ну
никак: никак
мочь: можешь
различать: различать
надо: Надо
старший: старшую
проход: Проходы
мина: минами
контролировать: контролирует
бег: Бегу
четыре: Четыре
возвышенность: возвышенность
левый: левый
фланг: флангах
ты: тебя
держать: держать
этот: эти
укрытие: укрытия
снять: снимут
белка: белку
разобраться: Разберусь
подобрать: Подбери
позиция: позицию
присмотреть: присмотреть
два: два
тут: Тут
работать: работать
встать: встанем
жопа: Жопу
горсть: горсть
скачка: скачками
я: Я
нога: нога
другой: другая
ребята: Ребята
птица: птицами
метнуться: метнулись
выполнять: выполнять
приказ: приказы
приняться: принялся
устанавливать: устанавливать
фугас: фугасы
дело: Дело
напротив: напротив
свой: своей
база: базы
кроме: кроме
правый: правый
крайний: крайних
иметься: имелось
еще: ещ
следовать: следовало
перекрыть: перекрыть
нужный: нужно
бы: бы
похорошему: похорошему
минимум: минимум
штука: штуки
заложить: заложить
запас: запасе
всего: всего
десять: десять
далекий: дальше
сложиться: сложится
неизвестный: неизвестно
поэтому: Поэтому
решить: решили
ограничиться: ограничиться
едва: Едва
уложиться: уложился
минута: минут
пока: Пока
настроить: настроил
замаскировал: замаскировал
послышаться: послышался
щелчок: щелчок
наушник: наушниках
затем: затем
наблюдать: наблюдаю
противник: противника
сколько: Сколько
добро: Добро
щелк: Щлк
двое: Двое
достать: Достанешь
думать: думаете
принять: Принял
вернуться: вернулся
дружный: дружный
писк: писк
запыхаться: запыхавшихся
девчонка: девчонкой
давать: Давайте
вот: вот
блок: блоками
оттуда: Оттуда
центральный: центральных
ладонь: ладони
второй: Второй
лис: Лис
похоже: Похоже
пара: парами
хоть: хоть
пугнуть: Пугнула
пусть: Пусть
ползти: ползут
минус: Минус
отходить: Отходит
отработать: Отработал
плазма: плазмой
менять: Меняй
уже: Уже
ранить: ранен
отползать: Отползает
умничка: Умничка
осторожней: Осторожней
мой: мой
палить: Палит
голова: головы
поднять: поднять
подстраховать: подстраховать
третий: третьего
прекрасно: прекрасно
прикрою: прикрою
постоянно: постоянно
мониторить: мониторишь
двоечка: Двоечка
пас: пасу
центр: центр
двойка: двойка
звучать: звучит
тоненький: тоненький
голосок: голосок
идти: Идт
осторожно: осторожно
граната: гранатой
тройка: Тройка
убрести: убрл
болезный: Болезный
уползти: уполз
запищать: Запищал
зуммер: зуммер
трехмерный: трехмерной
схема: схеме
угол: углу
интерфейс: интерфейса
засветиться: засветилась
желтый: жлтая
точка: точка
ктото: ктото
пожаловать: пожаловал
пятикратный: пятикратное
увеличение: увеличение
словно: Словно
прыжок: прыжком
приблизиться: приблизилась
круто: Круто
однако: однако
такой: такой
экипировка: экипировкой
воевать: воевать
хотя: Хотя
лучше: лучше
койка: койке
всякий: всяких
скафандр: скафандров
естественно: естественно
представлять: Представляем
внимание: вниманию
похожий: похожие
отобрать: отобрали
схожий: схожую
название: названию
смысл: смысле
литература: литературу
надежда: надежде
предоставить: предоставить
читатель: читателей
больше: больше
вариант: вариантов
интересный: интересные
обсуждение: Обсуждение
собственный: собственные
мнение: мнения
оставить: Оставьте
главный: главных
указать: Укажите
конкретно: конкретно
понравиться: понравилось
почему: почему
считать: считаете
