заголовок: Заголовок
олег: Олег
данильченко: Данильченко
имперский: Имперский
вояж: вояж
читать: читать
онлайн: онлайн
бесплатно: бесплатно
адрес: Адрес
здесь: здесь
быть: был
возможность: возможностями
весь: Все
текст: текст
электронный: электронной
книга: книге
совершенно: совершенно
целиком: целиком
полный: полную
версия: версию
в: в
некоторый: некоторые
случай: случаях
присутствовать: присутствует
краткий: краткое
содержание: содержание
город: города
м: М
спб: СПб
год: год
выпуск: выпуска
издательство: издательство
аста: АСТ
издательский: Издательский
дом: дом
ленинград: Ленинград
категория: категорию
боевой: Боевая
фантастика: фантастика
космический: Космическая
на: на
русский: русском
язык: языке
описание: описание
произведение: произведении
предисловие: предисловие
а: а
так: так
же: же
отзыв: отзывы
посетитель: посетителей
доступный: доступны
портал: портале
библиотека: Библиотека
либ: Либ
кат: Кат
создать: создана
для: для
любитель: любителей
полистать: полистать
хороший: хорошую
книжка: книжку
и: и
предлагать: Предлагаем
широкий: широкий
выбор: выбора
жанр: жанров
любовный: любовные
роман: романы
фэнтези: фэнтези
приключение: приключения
детектив: детективы
триллер: триллеры
эротика: эротика
документальный: документальные
научный: научные
юмористический: юмористические
анекдот: анекдоты
о: о
бизнес: бизнесе
проза: проза
детский: детские
сказка: сказки
религиия: религиии
новинка: новинки
православный: православные
старинный: старинные
про: про
компьютер: компьютеры
программирование: программирование
английский: английском
домоводство: домоводство
поэзия: поэзия
выбрав: Выбрав
по: по
душа: душе
вы: Вы
смочь: сможете
найти: нашли
действительно: действительно
стоить: стоящие
насладиться: насладиться
погружение: погружением
мир: мире
воображение: воображения
прочувствовать: прочувствовать
переживание: переживания
герой: героях
или: или
узнать: Узнайте
себя: себя
чтото: чтото
новый: новые
совершить: совершить
внутренний: внутреннее
открытие: открытие
подробный: Подробная
информация: информацию
ознакомление: ознакомления
текущий: текущему
запрос: запросу
представить: представлен
низкий: Ниже
к: к
чтение: чтение
аннотация: аннотацию
зависеть: зависит
от: от
тот: том
что: что
написать: напишите
сам: сама
автор: автора
если: Если
не: не
необходимый: необходимую
комментарий: комментарии
мы: Мы
постараться: постараемся
отыскать: отыскать
она: е
кто: кто
фамилия: фамилию
как: как
звать: зовут
список: списком
его: его
серия: сериям
уважаемые: Уважаемые
правообладатель: правообладатели
размещать: размещать
наш: нашем
сайт: сайте
у: у
любой: любой
зарегистрировать: зарегистрированного
пользователь: пользователя
ваш: ваши
опубликовать: опубликована
без: без
согласие: согласия
пожалуйста: пожалуйста
направить: направьте
жалоба: жалобу
заполните: заполните
форма: форму
обратный: обратной
связь: связи
течение: течение
час: часа
закрыть: закроем
доступ: доступ
нелегально: нелегально
разместить: размещенному
контент: контенту
разбить: разбитый
страница: страницу
система: Система
сохранение: сохранения
место: места
последний: последней
прочитать: прочитанные
позволять: позволяет
с: с
удобство: удобством
необходимость: необходимость
каждый: каждый
раз: раз
заново: заново
искать: искать
остановиться: остановились
поставить: Поставьте
закладка: Закладка
момент: момент
перейти: перейти
который: который
закончить: закончил
шрифт: Шрифт
интервал: Интервал
вот: вот
этот: этой
транспорт: транспорте
никакой: никаких
проблема: проблем
обзор: обзором
кабина: кабина
суть: суть
являться: являлась
один: одним
окно: окном
знать: Знай
глазеть: глазел
здоровье: здоровье
илья: Илья
он: он
ждать: ждал
когда: когда
появиться: появится
все: вс
появляться: появлялся
сначала: Сначала
возле: возле
терминал: терминала
увидеть: увидел
вместо: вместо
огромный: огромный
парк: парк
то: то
подумать: подумал
видимо: видимо
аэропорт: аэропорты
лифт: лифт
находиться: находится
отшиб: отшибе
это: этом
правильный: правильно
мало: мало
ли: ли
мочь: может
случиться: случиться
самолет: Самолеты
земля: Земле
тоже: Тоже
падать: падают
часто: часто
но: Но
сейчас: сейчас
они: они
лететь: летели
уже: уже
около: около
полчаса: получаса
приличный: приличной
скорость: скоростью
внизу: внизу
лес: лес
начать: начало
волноваться: волноваться
правда: Правду
сказать: сказать
иногда: иногда
замечать: замечал
глубина: глубине
лесной: лесного
массив: массива
какойто: какието
строение: строения
сверкать: сверкающие
луч: лучах
солнце: солнца
стеклянный: стеклянное
крыша: крышами
счет: счт
где: Где
блин: блин
еще: ещ
минута: минут
через: через
пять: пять
перестать: перестал
гадать: гадать
перебить: перебил
энди: Энди
держать: держала
за: за
рука: руку
упоение: упоением
щебетать: щебетала
расписывать: расписывая
красота: красоту
курорт: курортах
метрополия: Метрополии
вникнуть: вникла
вопрос: вопрос
весело: весело
рассмеяться: рассмеялась
лекция: лекцию
вредить: вредит
экология: экологии
техногенный: техногенная
цивилизация: цивилизация
ее: е
слово: слов
выходить: выходило
человечество: человечество
давно: давно
жить: Живут
планета: планет
уважать: уважая
природа: природу
свести: свело
минимум: минимуму
свой: сво
пребывание: пребывание
подавлять: Подавляющее
большинство: большинство
человек: человеком
космос: космосе
станция: станциях
после: после
разобраться: разобрались
гравитация: гравитацией
научиться: научившись
создавать: создавать
искусственный: искусственную
отпасть: отпала
теперь: теперь
только: только
отдыхать: отдыхающих
обслуживать: обслуживает
эмиграционный: Эмиграционный
учреждение: учреждения
традиция: традиции
базироваться: базируются
связать: связано
эмигрант: эмигранты
освобождать: освобождают
кс: КС
пиратский: пиратского
рабство: рабства
бывать: бывают
совсем: совсем
уж: уж
отсталый: отсталых
понятие: понятия
иметь: имеют
их: их
душевный: душевного
спокойствие: спокойствия
строить: строят
подобный: подобные
заведение: заведения
поверхность: поверхности
считаться: Считается
проще: проще
освоиться: освоиться
ожидать: ожидал
илюха: Илюха
предвидеться: предвидится
обозримый: обозримом
будущее: будущем
прибыть: прибыли
центр: центр
рассказать: рассказала
порядочный: порядочные
мужчина: мужчины
должный: должны
перебивать: перебивать
женщина: женщину
рассказывать: рассказывает
такой: такой
бестолочь: бестолочам
братец: братец
реагировать: Реагируя
наезд: наезд
джойло: Джойл
закатить: закатил
глаз: глаз
зенит: зенит
укрыться: укрылось
зоркий: зорких
сестра: сестры
собраться: собралась
пройтись: пройтись
заодно: заодно
повод: поводу
вопиющий: вопиющего
неуважение: неуважения
такси: такси
снижаться: снижаться
поход: Походу
поражать: поражал
здание: здание
светлый: светлое
внутри: внутри
утопать: утопающее
зелень: зелени
снаружи: снаружи
всего: всего
два: два
этаж: этажа
занимать: занимающее
довольно: довольно
больший: большую
площадь: площадь
процедура: Процедура
регистрация: регистрации
принятие: принятия
присяга: присяги
верность: верность
империя: Империи
много: много
время: времени
занять: заняло
подготовить: подготовлен
вылупиться: вылупившиеся
из: из
криостаз: криостаза
мариноваться: маринуются
три: три
день: дня
галопом: галопом
протащить: протащили
инстанция: инстанциям
дать: дала
даже: даже
толком: толком
зубовный: зубовным
скрежет: скрежетом
чиновник: чиновника
сообщить: сообщил
куратор: куратором
другой: другой
скорый: скорее
проплатила: проплатил
якобы: якобы
бесхозный: бесхозный
лоялитипоинт: лоялитипоинт
расстроиться: расстроился
немного: немного
более: более
торжественный: торжественного
тут: тут
пробубнили: пробубнили
потом: потом
спросить: спросили
типа: типа
согласный: согласен
вариант: вариантов
ответ: ответов
да: ДА
нет: нет
естественный: Естественно
ну: Ну
чудной: чудно
ты: тебе
направление: направление
дуть: дуй
освидетельствование: освидетельствование
фпи: ФПИ
дунуть: дунул
хотя: Хотя
потупить: потупил
бы: бы
маленько: маленько
цапнуть: цапнула
прохладный: прохладной
ладошка: ладошкой
потащить: потащила
бульдозер: бульдозер
далекий: дальше
удивительно: Удивительно
сколько: сколько
энергия: энергии
девушка: девушке
знаменитый: Знаменитые
батарейка: батарейки
энерджайзер: Энерджайзер
нервно: нервно
курить: курят
сторонка: сторонке
получение: Получение
карта: карты
опять: опять
прийтись: пришлось
раздеться: раздеться
угнездиться: угнездиться
очередной: очередное
чудо: чудо
технология: технологии
напоминать: напоминающее
знакомый: знакомую
медкапсула: медкапсулу
расширить: расширенными
постичь: постигло
глубокий: глубокое
разочарование: разочарование
интеллект: интеллектом
сто: сто
десять: десять
пункт: пунктов
всегда: всегда
считать: считаете
достаточно: достаточно
умный: умным
знание: Знания
даваться: давались
легко: легко
школа: школе
морской: морской
академия: академии
б: б
инцидент: инцидент
драка: дракой
особый: особого
труд: труда
уверенный: уверен
оказываться: оказывается
середнячок: середнячок
надо: Надо
говорить: говорила
убить: убит
мрачнее: мрачнее
туча: тучи
остальной: остальные
параметр: параметры
впечатляли: впечатляли
медик: медик
проводить: проводил
изыскание: изыскания
восхищенно: восхищенно
присвистнуть: присвистнул
ни: ни
думать: думаете
кроме: кроме
мозг: мозг
размер: размером
грецкий: грецкий
орех: орех
сравниться: сравниться
конченый: конченой
блонда: блонды
слышать: слышал
под: Под
купол: куполом
череп: черепа
гулкий: гулко
биться: бился
отражаться: отражаясь
свод: сводов
повторяясь: повторяясь
до: до
бесконечность: бесконечности
представлять: Представляем
внимание: вниманию
похожий: похожие
отобрать: отобрали
схожий: схожую
название: названию
смысл: смысле
литература: литературу
надежда: надежде
предоставить: предоставить
читатель: читателей
больше: больше
интересный: интересные
обсуждение: Обсуждение
просто: просто
собственный: собственные
мнение: мнения
оставить: Оставьте
главный: главных
указать: Укажите
конкретно: конкретно
понравиться: понравилось
почему: почему
