заголовок: Заголовок
олег: Олег
данильченко: Данильченко
имперский: Имперский
вояж: вояж
читать: читать
онлайн: онлайн
бесплатно: бесплатно
адрес: Адрес
здесь: Здесь
быть: было
возможность: Возможность
весь: всей
текст: текст
электронный: электронной
книга: книге
совершенно: совершенно
целиком: целиком
полный: полную
версия: версию
в: в
некоторый: некоторых
случай: случаях
присутствовать: присутствует
краткий: краткое
содержание: содержание
город: Город
м: М
спб: СПб
год: год
выпуск: выпуска
издательство: издательство
аста: АСТ
издательский: Издательский
дом: дом
ленинград: Ленинград
категория: категорию
боевой: Боевая
фантастика: фантастика
космический: Космическая
на: на
русский: русский
язык: языке
описание: описание
произведение: произведении
предисловие: предисловие
а: а
так: так
же: же
отзыв: отзывы
посетитель: посетителей
доступный: доступны
портал: портале
библиотека: Библиотека
либ: Либ
кат: Кат
создать: создана
для: для
любитель: любителей
полистать: полистать
хороший: хорошую
книжка: книжку
и: и
предлагать: Предлагаем
широкий: широкий
выбор: выбора
жанр: жанров
любовный: любовные
роман: романы
фэнтези: фэнтези
приключение: приключения
детектив: детективы
триллер: триллеры
эротика: эротика
документальный: документального
научный: научные
юмористический: юмористические
анекдот: анекдоты
о: о
бизнес: бизнесе
проза: проза
детский: детские
сказка: сказки
религиия: религиии
новинка: новинки
православный: православные
старинный: старинные
про: про
компьютер: компьютеры
программирование: программирование
английский: английском
домоводство: домоводство
поэзия: поэзия
выбрав: Выбрав
по: по
душа: душе
вы: Вы
смочь: смог
найти: нашли
действительно: действительно
стоить: стоящие
насладиться: насладиться
погружение: погружением
мир: мир
воображение: воображения
прочувствовать: прочувствовать
переживание: переживания
герой: героях
или: или
узнать: Узнайте
себя: себе
чтото: чтото
новый: новые
совершить: совершить
внутренний: внутреннее
открытие: открытие
подробный: Подробная
информация: информацию
ознакомление: ознакомления
текущий: текущему
запрос: запросу
представить: представлен
низкий: Ниже
к: к
чтение: чтение
аннотация: аннотацию
зависеть: зависит
от: от
тот: той
что: что
написать: напишите
сам: сам
автор: автора
если: если
не: не
необходимый: необходимую
комментарий: комментарии
мы: Мы
постараться: постараемся
отыскать: отыскать
она: ней
кто: Кто
фамилия: фамилию
как: как
звать: зовут
список: списком
его: его
серия: сериям
уважаемые: Уважаемые
правообладатель: правообладатели
размещать: размещать
наш: нашем
сайт: сайте
у: у
любой: любой
зарегистрировать: зарегистрированного
пользователь: пользователя
ваш: ваши
опубликовать: опубликована
без: без
согласие: согласия
пожалуйста: пожалуйста
направить: направьте
жалоба: жалобу
заполните: заполните
форма: форму
обратный: обратной
связь: связи
течение: течение
час: часов
закрыть: закроем
доступ: доступ
нелегально: нелегально
разместить: размещенному
контент: контенту
разбить: разбитый
страница: страницу
система: Система
сохранение: сохранения
место: места
последний: последней
прочитать: прочитанные
позволять: позволяет
с: С
удобство: удобством
необходимость: необходимости
каждый: каждый
раз: раз
заново: заново
искать: искать
остановиться: остановились
поставить: Поставьте
закладка: Закладка
момент: момент
перейти: перейти
который: которой
закончить: закончили
шрифт: Шрифт
интервал: Интервал
ловить: Ловите
суукииииииия: Суукииииииии
древний: Древняя
машина: машина
пробудиться: пробудилась
сон: сна
хоть: хоть
находиться: находился
глубоко: глубоко
под: под
земля: землей
чуткий: чуткие
датчик: датчики
уловить: уловили
знакомый: знакомую
команда: команду
координата: Координаты
планета: Планету
название: названию
суук: Суук
память: памяти
транспортный: Транспортный
узел: узел
вот: Вот
начаться: началась
штатный: штатная
процедура: процедура
отправка: отправки
правда: Правда
груз: груз
великоватый: великоват
нынешний: нынешнего
состояние: состояния
но: но
бездушный: бездушная
вопрос: вопросов
задавать: задат
должный: должна
выполнять: выполнять
выполнить: выполнила
удивленный: Удивленные
боевик: боевиков
увидеть: увидел
над: над
где: Где
засесть: засел
наглый: наглый
появиться: появился
темный: темный
купол: купол
это: это
верхушка: верхушка
силовой: силовой
сфера: сферы
остальной: остальными
часть: часть
скрываться: скрывалась
понимать: понимая
происходить: происходит
они: их
сорваться: сорвались
пытаться: пытаясь
быстрый: быстрей
взять: взять
неверный: неверного
этот: этой
громкий: громким
хлопок: хлопком
большой: больше
похожий: похожие
выстрел: выстрел
противотанковый: противотанкового
орудие: орудия
модуль: модуль
отдать: отдал
бабааа: Бабаааах
несколько: несколько
десяток: десятков
тонна: тонн
грунт: грунт
вместе: вместе
илья: Илья
лежать: лежали
сверху: сверху
мюнхгаузен: Мюнхгаузен
огромный: огромной
пушечный: пушечном
ядро: ядре
исчезнуть: исчезли
потом: потом
рвануть: рванули
изрядно: изрядно
изношенный: изношенные
накопитель: накопители
тяжкий: Тяжкий
взрыв: взрыв
уничтожить: уничтожил
подбегать: подбегающих
только: только
уже: уже
видеть: видел
он: ему
потерять: потерял
сознание: сознание
за: за
секунда: секунды
до: до
сначала: сначала
почувствовать: почувствовал
словно: словно
бы: бы
скручивать: скручивает
манер: манер
тряпка: тряпки
мытье: мытья
пол: полов
когда: когда
отжимать: отжимают
наступить: наступило
темнота: темнота
глава: Глава
почта: почта
сработать: сработала
безукоризненно: безукоризненно
посылка: Посылка
удачно: удачно
дойти: дошла
адресат: адресата
удача: удача
ограничиваться: ограничивалась
принять: принял
подвергнуться: подвергся
такой: таким
испытание: испытаниям
земной: земные
собрат: собрат
когдато: когдато
называться: называлась
ломать: ломали
чудовищный: чудовищные
катаклизм: катаклизмы
вернее: Вернее
то: то
установить: установлена
коснуться: коснулось
очень: очень
уж: уж
сильный: сильные
изменение: изменения
ландшафт: ландшафта
всего: всего
пять: пять
метр: метров
естественный: естественных
отложение: отложений
покрывать: покрывали
приемный: приемный
да: да
расти: росшими
вековой: вековой
лес: лес
оказаться: оказался
глубокий: глубже
пятнадцать: пятнадцать
получиться: получилась
славный: славная
могила: могиле
заживо: заживо
погрести: погребнный
еще: ещ
закон: Законы
физик: физики
никто: никто
отменять: отменял
ну: ну
мочь: может
два: два
физический: физических
тело: тело
один: одна
точка: точке
пространство: пространства
одновременно: одновременно
тут: тут
шар: Шар
диаметр: диаметром
состоять: состоящий
из: из
скальный: скальных
обломок: обломков
смешанный: смешанных
пополам: пополам
глина: глиной
попросту: попросту
вытолкнуть: вытолкнул
дерево: деревья
сторона: стороны
повезти: повезло
насадить: насаженным
какойлибо: какоелибо
все: вс
пройти: прошли
благодаря: благодаря
составлять: составляющей
там: там
ни: ни
результат: результате
образоваться: образовалась
воронка: воронки
оочень: оочень
серьезный: серьезных
размер: размеров
центр: центре
ее: е
куча: куче
капитан: капитана
очнуться: очнулся
ночь: ночь
лежа: Лжа
спина: спине
тупо: тупо
пялиться: пялился
звезда: звзды
привести: привести
мысль: мысли
порядок: порядок
чем: Чем
приложить: приложило
чех: чехам
почему: почему
живой: жив
ведь: Ведь
ощущение: ощущениям
какойто: какието
тепло: тепло
пахнуть: пахнет
прелый: прелой
древесина: древесиной
примесь: примесью
озон: озона
после: после
гроза: грозы
много: много
всякий: всяких
звездный: звздное
небо: небо
абсолютно: абсолютно
родный: родное
както: както
внимание: вниманию
ладно: Ладно
решить: решил
илюха: Илюха
нет: нет
слава: слава
бог: богу
проблема: проблемами
разбираться: разбирался
мера: мере
поступление: поступления
начало: начала
надо: надо
проверить: проверить
демьяненко: Демьяненко
мертвый: мртв
причем: причем
давно: давно
глаз: глазах
открыть: открытым
казалось: казалось
внимательно: внимательно
всматриваться: всматривается
пульс: Пульс
проверять: проверять
потребоваться: потребовалось
окоченеть: окоченело
простить: Прости
братуха: братуха
тихо: тихо
произнести: произнес
закрывать: закрывая
допереть: допр
я: я
ты: тебя
похоронить: похоронил
положенный: положено
колено: Колено
сильно: сильно
опухнуть: опухло
болеть: болело
время: времени
простреливая: простреливая
боль: болью
темнеть: темнеющий
несмотря: несмотря
друг: друга
неглубокий: неглубокой
отрыть: отрыл
прямо: прямо
пообещать: Пообещав
вернуться: вернтся
сюда: сюда
выжить: выживет
добраться: добертся
свой: свои
далее: Далее
взяться: взялся
вооружение: вооружение
негусто: Негусто
магазин: магазина
разгрузка: разгрузки
теперь: теперь
надобность: надобности
расстрелять: расстрелял
маловатый: маловато
делать: делать
нечего: нечего
штыкнож: штыкнож
граната: граната
вог: ВОГ
подствольник: подствольнике
пыл: пылу
бой: боя
нее: не
забыться: забылось
эфка: эфка
фляга: флягу
вода: воды
имущество: имущество
пока: Пока
барахло: барахлом
утро: утро
взойти: взошло
солнце: солнце
погрузить: Погруженный
сразу: сразу
обратить: обратил
окружать: окружающий
пейзаж: пейзаж
выронить: выронил
собираться: собирался
утолить: утолить
жажда: жажду
застынуть: застыл
рот: ртом
напоминать: напоминал
кадр: кадры
фильм: фильма
падение: падения
тунгусский: Тунгусского
метеорит: метеорита
лишь: лишь
разница: разницей
повалить: поваленные
тощий: тощие
ствол: стволы
сюжет: сюжета
многовековый: многовековые
исполин: исполины
обхват: обхвате
ровненький: ровненько
уложить: уложенные
вокруг: вокруг
восседать: восседал
каменный: каменной
далекий: дальше
вакханалия: вакханалии
стена: стеной
стоять: стоял
густой: густой
даже: даже
отсюда: отсюда
понятный: понятно
чужой: чужой
никогда: никогда
бывать: бывал
джунгли: джунгли
неподалеку: неподалеку
специалист: специалисту
ботаника: ботанике
ясный: ясно
божий: божий
день: день
другой: другое
сюрреалистичный: Сюрреалистичная
картинка: картинка
представлять: Представляем
отобрать: отобрали
схожий: схожую
смысл: смысле
литература: литературу
надежда: надежде
предоставить: предоставить
читатель: читателей
больше: больше
вариант: вариантов
интересный: интересные
обсуждение: Обсуждение
просто: просто
собственный: собственные
мнение: мнения
оставить: Оставьте
думать: думаете
главный: главных
указать: Укажите
конкретно: конкретно
понравиться: понравилось
считать: считаете
