заголовок: Заголовок
олег: Олег
данильченко: Данильченко
имперский: Имперский
вояж: вояж
читать: читать
онлайн: онлайн
бесплатно: бесплатно
адрес: Адрес
здесь: здесь
быть: будешь
возможность: Возможность
весь: всю
текст: текст
электронный: электронной
книга: книге
совершенно: совершенно
целиком: целиком
полный: полной
версия: версию
в: в
некоторый: некоторых
случай: случаях
присутствовать: присутствует
краткий: краткое
содержание: содержание
город: Город
м: М
спб: СПб
год: год
выпуск: выпуска
издательство: издательство
аста: АСТ
издательский: Издательский
дом: дома
ленинград: Ленинград
категория: категорию
боевой: Боевая
фантастика: фантастика
космический: Космическая
на: на
русский: русском
язык: языке
описание: описание
произведение: произведении
предисловие: предисловие
а: а
так: так
же: же
отзыв: отзывы
посетитель: посетителей
доступный: доступны
портал: портале
библиотека: Библиотека
либ: Либ
кат: Кат
создать: создана
для: для
любитель: любителей
полистать: полистать
хороший: хорошего
книжка: книжку
и: и
предлагать: Предлагаем
широкий: широкий
выбор: выбора
жанр: жанров
любовный: любовные
роман: романы
фэнтези: фэнтези
приключение: приключения
детектив: детективы
триллер: триллеры
эротика: эротика
документальный: документальные
научный: научные
юмористический: юмористические
анекдот: анекдоты
о: о
бизнес: бизнесе
проза: проза
детский: детские
сказка: сказках
религиия: религиии
новинка: новинки
православный: православные
старинный: старинные
про: про
компьютер: компьютеры
программирование: программирование
английский: английском
домоводство: домоводство
поэзия: поэзия
выбрав: Выбрав
по: по
душа: душой
вы: Вы
смочь: смог
найти: нашла
действительно: действительно
стоить: стоящая
насладиться: насладиться
погружение: погружением
мир: миры
воображение: воображение
прочувствовать: прочувствовать
переживание: переживания
герой: героях
или: или
узнать: Узнайте
себя: себя
чтото: чтото
новый: новые
совершить: совершить
внутренний: внутреннее
открытие: открытие
подробный: Подробная
информация: информацию
ознакомление: ознакомления
текущий: текущему
запрос: запросу
представить: представить
низкий: Ниже
к: к
чтение: чтение
аннотация: аннотацию
зависеть: зависит
от: от
тот: того
что: что
написать: напишите
сам: сам
автор: автора
если: если
не: не
необходимый: необходимую
комментарий: комментарии
мы: Мы
постараться: постараемся
отыскать: отыскать
она: она
кто: Кто
фамилия: фамилию
как: как
звать: зовут
список: списком
его: его
серия: сериям
уважаемые: Уважаемые
правообладатель: правообладатели
размещать: размещать
наш: наши
сайт: сайте
у: у
любой: любую
зарегистрировать: зарегистрированного
пользователь: пользователя
ваш: ваши
опубликовать: опубликована
без: без
согласие: согласия
пожалуйста: пожалуйста
направить: направьте
жалоба: жалобу
заполните: заполните
форма: форму
обратный: обратной
связь: связи
течение: течение
час: часов
закрыть: закрыть
доступ: доступ
нелегально: нелегально
разместить: размещенному
контент: контенту
разбить: разбитый
страница: страницу
система: Система
сохранение: сохранения
место: место
последний: последней
прочитать: прочитанные
позволять: позволяет
с: со
удобство: удобством
необходимость: необходимости
каждый: каждый
раз: раз
заново: заново
искать: искать
остановиться: остановились
поставить: Поставьте
закладка: Закладка
момент: момент
перейти: перейти
который: которая
закончить: закончили
шрифт: Шрифт
интервал: Интервал
когда: Когда
он: его
это: это
спросить: спросил
согласный: согласна
ли: ли
ее: е
зеленый: зеленые
глаз: глазами
сначала: сначала
засиять: засияли
потом: потом
наполниться: наполнились
слеза: слезами
затем: Затем
забраться: забралась
рука: руками
тихо: тихо
уютно: уютно
там: там
пристроиться: пристроилась
иногда: иногда
всхлипывать: всхлипывая
успокоенно: успокоенно
вздыхая: вздыхая
бы: бы
наконец: наконец
получить: получила
мечтать: мечтала
этот: этой
жизнь: жизни
сержантабордажник: сержантабордажник
снайпер: снайпер
электронщик: электронщик
секция: секции
напичкать: напичканная
имплантат: имплантатами
самый: самое
баловать: балуй
илья: Илья
мочь: мог
усомниться: усомниться
собственный: собственные
видеть: вижу
работать: работает
тренировка: тренировках
ничто: Ничего
оставаться: оставалось
ночной: ночной
энди: Энди
однако: Однако
долго: долго
коротко: коротко
говориться: говорится
но: но
настать: настал
непобедимый: Непобедимого
прибытьтаки: прибылтаки
назначение: назначения
пока: Пока
тяжелый: тяжелый
крейсер: крейсер
швартоваться: швартовался
станция: СТАНЦИЯ
илюха: Илюха
торчать: торчал
обзорный: обзорной
палуба: палубе
немой: немым
восхищение: восхищением
глазеть: глазел
воистину: воистину
циклопический: циклопическое
сооружение: сооружение
мера: мере
приближение: приближения
становиться: становилось
больше: больше
большой: больше
обзор: обзор
полностью: полностью
путь: пути
восхищаться: восхищался
размер: размерами
пятисотметровый: Пятисотметровая
дура: дура
построить: построенная
из: из
сорт: сортов
сталь: стали
композитный: композитной
бронь: брони
сложный: сложно
электроника: электроникой
мощный: мощнейшим
вооружение: вооружением
казаться: казалось
песчинка: песчинкой
сравнение: сравнению
конструкция: конструкцией
вот: Вот
уж: уж
тут: тут
называться: называется
скорлупка: скорлупка
болтаться: болтается
орбита: орбите
земля: Земле
гордо: гордо
мкс: МКС
да: Да
говорить: говорят
слово: слов
уже: уже
нет: нет
один: одни
слюни: слюни
остаться: остались
впечатлить: впечатлн
поразить: поражн
объяснить: объяснить
вид: виду
наверное: наверное
иметь: имеющий
дурацкий: дурацкий
потому: потому
ряд: рядом
эн: Эн
потешаться: потешалась
над: над
программа: программе
ты: ты
хихикать: хихикаешь
рыжий: рыжая
бестия: бестия
шутливо: шутливо
обидеться: обиделся
сторона: стороны
спрашивать: спрашивал
ну: Ну
илио: Илио
я: я
поражать: поражает
теперь: теперь
понимать: понимаю
какой: какую
огромный: огромная
временной: временная
пропасть: пропасть
разделять: разделяет
чувствовать: чувствуешь
дикарем: дикарем
каменный: каменным
топор: топором
под: под
мышка: мышкой
плевать: плевать
выглядеть: выглядишь
любимый: любимый
мой: моей
дикарь: дикарь
сказать: сказано
только: только
забыть: забыли
голова: головой
окунуться: окуншься
даже: даже
захотеть: захотеть
попробовать: попробуй
слушать: Слушай
солнышко: солнышко
яркий: яркое
вообще: вообще
всего: всего
пара: пару
неделя: недель
встретиться: встретились
вдруг: вдруг
реально: Реально
мерка: меркам
за: за
еще: ещ
гражданин: гражданин
знать: знает
получиться: получится
задумать: задумал
откуда: откуда
горе: горе
можно: можно
почему: почему
любить: любишь
просто: просто
незачем: незачем
разбираться: разбираться
предпосылка: предпосылках
войти: вошел
док: доком
столовая: столовую
команда: команды
такой: такую
невозмутимый: невозмутимым
создаваться: создавалось
впечатление: впечатление
будто: будто
бывать: бывал
корабль: кораблях
смешно: смешно
издеваться: издевался
брат: братом
попытаться: попытается
напугать: напуган
обычно: Обычно
перед: перед
робеть: робеют
задница: задницу
приземлить: приземлил
чей: чьим
лоб: лбом
энергетический: энергетические
щит: щиты
линкор: линкора
пробить: пробить
догадаться: догадалась
защитный: защитная
маска: маска
дело: деле
растерять: растерян
увидеть: увидел
переживать: переживал
свой: своими
друг: друг
выжить: выжил
человек: человека
почувствовать: почувствовала
озарение: озарение
никто: Никому
отдать: отдам
правда: правду
загрызть: загрызу
оспорить: оспорить
понять: понял
куда: Куда
деться: денешься
никуда: никуда
день: дне
черный: черной
дыра: дыры
достать: достать
надо: надо
доставать: доставать
достаться: достанусь
существовать: существует
любовь: любовь
первый: первого
взгляд: взгляда
видимо: видимо
много: много
знакомый: знакомых
девчонка: девчонок
мысль: мыслях
чтобы: чтобы
замуж: замуж
позвать: позвать
бабник: бабник
картинный: Картинно
всплеснуть: всплеснула
нуууа: Нуууу
когдато: когдато
впервые: впервые
верный: верный
услышать: услышал
твой: твой
голос: голос
джойло: Джойл
попросить: попросил
заветный: заветную
бутылка: бутылку
помнить: помнишь
тоскливый: тоскливо
представлять: Представляем
погибнуть: погиб
отец: отец
похоронить: похоронить
покинуть: покинуть
судно: судно
война: война
плен: плен
списать: списали
счет: счетов
побег: Побег
подорваться: подорвался
растяжка: растяжке
суметь: сумел
помочь: помочь
осознание: осознание
оказаться: оказалась
черт: чрта
куличок: куличках
хрен: хрен
где: где
единственный: единственный
потерять: потерял
хотеться: Хотелось
выть: выть
белый: белый
свет: свет
рядом: рядом
смотреть: смотрела
зеленючий: зеленючими
глазище: глазищами
впитывать: впитывала
боль: боль
разом: разом
пахнуть: пахла
подомашнему: подомашнему
разве: Разве
влюбиться: влюбиться
женщина: женщину
красивый: красивую
дорогой: дорогая
живой: жив
точка: точка
внимание: вниманию
похожий: похожие
отобрать: отобрали
схожий: схожую
название: названию
смысл: смысле
литература: литературу
надежда: надежде
предоставить: предоставить
читатель: читателей
вариант: вариантов
интересный: интересные
обсуждение: Обсуждение
мнение: мнения
оставить: Оставьте
думать: думаете
главный: главных
указать: Укажите
конкретно: конкретно
понравиться: понравилось
считать: считаете
