заголовок: Заголовок
олег: Олег
данильченко: Данильченко
имперский: Имперский
вояж: вояж
читать: читать
онлайн: онлайн
бесплатно: бесплатно
адрес: Адрес
здесь: Здесь
быть: будет
возможность: возможность
весь: вс
текст: текст
электронный: электронной
книга: книге
совершенно: совершенно
целиком: целиком
полный: полную
версия: версию
в: в
некоторый: некоторых
случай: случаях
присутствовать: присутствует
краткий: краткое
содержание: содержание
город: Город
м: М
спб: СПб
год: год
выпуск: выпуска
издательство: издательство
аста: АСТ
издательский: Издательский
дом: дома
ленинград: Ленинград
категория: категорию
боевой: Боевая
фантастика: фантастика
космический: Космическая
на: на
русский: русском
язык: языке
описание: описание
произведение: произведении
предисловие: предисловие
а: а
так: так
же: же
отзыв: отзывы
посетитель: посетителей
доступный: доступны
портал: портале
библиотека: Библиотека
либ: Либ
кат: Кат
создать: создана
для: для
любитель: любителей
полистать: полистать
хороший: Хорошо
книжка: книжку
и: и
предлагать: Предлагаем
широкий: широкий
выбор: выбора
жанр: жанров
любовный: любовные
роман: романы
фэнтези: фэнтези
приключение: приключения
детектив: детективы
триллер: триллеры
эротика: эротика
документальный: документальные
научный: научные
юмористический: юмористические
анекдот: анекдоты
о: о
бизнес: бизнесе
проза: проза
детский: детские
сказка: сказки
религиия: религиии
новинка: новинки
православный: православные
старинный: старинные
про: про
компьютер: компьютеры
программирование: программирование
английский: английском
домоводство: домоводство
поэзия: поэзия
выбрав: Выбрав
по: по
душа: душе
вы: Вы
смочь: сможете
найти: найдя
действительно: действительно
стоить: стоит
насладиться: насладиться
погружение: погружением
мир: мир
воображение: воображения
прочувствовать: прочувствовать
переживание: переживания
герой: героях
или: или
узнать: Узнайте
себя: себе
чтото: чтото
новый: новые
совершить: совершить
внутренний: внутреннее
открытие: открытие
подробный: Подробная
информация: информации
ознакомление: ознакомления
текущий: текущему
запрос: запросу
представить: представлен
низкий: Ниже
к: к
чтение: чтение
аннотация: аннотацию
зависеть: зависит
от: от
тот: Те
что: что
написать: напишите
сам: сам
автор: автора
если: если
не: не
необходимый: необходимую
комментарий: комментарии
мы: Мы
постараться: постараемся
отыскать: отыскать
она: е
кто: кого
фамилия: фамилию
как: Как
звать: зовут
список: списком
его: его
серия: сериям
уважаемые: Уважаемые
правообладатель: правообладатели
размещать: размещать
наш: нашем
сайт: сайте
у: у
любой: любой
зарегистрировать: зарегистрированного
пользователь: пользователя
ваш: ваши
опубликовать: опубликована
без: без
согласие: согласия
пожалуйста: пожалуйста
направить: направьте
жалоба: жалобу
заполните: заполните
форма: форму
обратный: обратной
связь: связи
течение: течение
час: часов
закрыть: закроем
доступ: доступ
нелегально: нелегально
разместить: размещенному
контент: контенту
разбить: разбитый
страница: страницу
система: Система
сохранение: сохранения
место: места
последний: последнего
прочитать: прочитанные
позволять: позволяет
с: с
удобство: удобством
необходимость: необходимости
каждый: каждый
раз: раз
заново: заново
искать: искать
остановиться: остановились
поставить: Поставьте
закладка: Закладка
момент: момент
перейти: перейти
который: которому
закончить: закончили
шрифт: Шрифт
интервал: Интервал
резонный: Резонный
вопрос: вопрос
дело: дело
правило: правилам
должный: должен
внедрить: внедрены
среда: среду
учиться: учащихся
преподаватель: преподавателей
свой: своему
сотрудник: сотрудника
положенный: положено
но: но
это: этому
мочь: могу
вызвать: вызвать
подозрение: подозрения
юноша: юноша
уже: уже
сказать: сказал
более: более
находиться: находитесь
группа: группе
господин: господина
бал: Балах
вернуть: Врни
давно: давно
иметь: имеет
он: его
зуб: зуб
удачно: удачно
складываться: складывается
решение: решение
я: я
согласный: согласен
снова: снова
подтверждать: подтверждаете
мой: мое
мнение: мнения
благоразумный: благоразумном
человек: человек
сейчас: сейчас
минутка: Минутку
док: док
знать: знаю
там: там
непобедимый: Непобедимого
глаз: глаза
тори: Тори
мелькнуть: мелькнуло
илюха: Илюха
уверенный: уверен
ошибиться: ошибся
нехороший: нехорошее
чувство: чувство
поселиться: поселилось
порядок: порядке
насколько: насколько
больший: большего
секретный: Секретная
операция: операция
ведь: ведь
развести: развел
рука: руками
нужный: нужны
допуск: допуск
подобный: подобной
вот: Вот
бы: бы
молодой: молодой
принять: приняли
предложение: предложение
нет: нет
договориться: договорились
точно: точно
ладный: Ладно
ладно: Ладно
засмеяться: засмеялся
бывший: бывшему
медик: медик
большой: велик
пока: пока
насчет: насчт
извиняться: извиняюсь
смог: смог
теперь: Теперь
просить: прошу
выход: выход
вывести: выведу
отсюда: отсюда
то: то
два: два
престарелый: престарелых
ветеран: ветерана
штурм: штурмом
взять: возьмт
заведение: заведение
везти: Везт
урод: уродов
всякий: всяких
тоже: тоже
баланс: баланс
равновесие: равновесие
усмехнуться: усмехнулся
грег: Грег
минута: минут
через: через
пять: пять
идти: идти
вслед: вслед
за: за
куратор: куратором
илья: Илья
увидеть: увидел
полицейский: полицейских
конвоировать: конвоируют
они: их
навстречу: навстречу
чернокожий: чернокожего
б: б
ничто: ничего
примечательный: примечательного
габарит: габариты
просто: просто
огромный: огромен
думать: думаете
после: после
джойло: Джойла
удивить: удивить
трудный: трудно
видимо: видимо
этот: этого
чудовищно: чудовищно
рост: рост
братец: братца
энди: Энди
под: под
двадцать: двадцать
тут: тут
половина: половиной
при: При
только: только
поражать: поражал
выдающийся: выдающаяся
мускулатура: мускулатура
буквально: буквально
рвать: рвала
тюремный: тюремную
роба: робу
похоже: Похоже
подходить: подходящего
размерчик: размерчика
склад: складе
околоточный: околоточном
найтись: нашлось
блюститель: Блюстители
закон: закона
непринужденно: непринужденно
разговаривать: разговаривая
дурмашина: дурмашина
захотеть: захочет
хрен: хрен
удержать: удержит
обреченно: обречнно
плестись: плелась
сзади: сзади
выражение: выражение
лицо: лице
былинный: былинного
богатырь: богатыря
заинтересовать: заинтересовало
особо: особо
открытый: открытом
простодушный: простодушном
деревенский: деревенского
увалень: увальня
застынуть: застыла
обиженнорастерять: обиженнорастерянная
гримаса: гримаса
казаться: Казалось
до: до
сей: сих
пора: пор
поверить: поверить
происходить: происходящее
понимать: понимает
наказывать: наказывают
ну: Ну
ребенок: ребенок
ни: ни
дать: дали
сначала: сначала
конфета: конфету
потом: потом
выхватить: выхватили
из: из
рот: рта
сунуть: сунуть
щека: щку
данный: данной
власть: властью
поинтересоваться: поинтересоваться
хотеть: хочу
законопатить: законопатить
парень: парень
интуиция: Интуиция
подсказывать: подсказывает
наказать: наказать
незаслуженно: незаслуженно
знаете: Знаете
сколько: сколько
осудить: осужденных
работать: работает
каторга: каторги
помочь: помочь
илио: Илио
почему: почему
узнавать: узнаем
спустя: Спустя
десять: десять
разговор: разговора
вернуться: вернулся
банальный: Банальная
история: история
подковерный: Подковрная
грызня: грызня
корпорат: корпоратов
вечно: вечно
делить: делят
кивок: кивок
сторона: сторону
верзила: верзилы
телохранитель: телохранитель
один: один
покушение: покушение
хозяин: хозяин
выполнить: выполнив
работа: работу
уничтожить: уничтожив
исполнитель: исполнителя
заказчик: заказчик
оказаться: оказался
чересчур: чересчур
крученый: крученым
выставить: выставил
точность: точностью
наоборот: наоборот
громила: громилы
попадать: попадал
статья: статью
недолго: Недолго
способ: способов
выкрутиться: выкрутиться
создаться: создавшейся
ситуация: ситуация
обвинить: обвинил
телохрана: телохрана
самодеятельность: самодеятельности
свалить: свалив
вина: вину
довольный: довольны
хорошо: хорошо
загреметь: загремел
понятный: Понятно
земля: Земле
называться: называется
разобраться: разобраться
следовать: следует
попасть: попало
хм: Хм
точнее: точнее
придумать: придумаешь
надо: Надо
вооружение: вооружение
землянин: Землянин
вытаращить: вытаращил
разочаровывать: разочаровывайте
спасти: спасли
пройти: пройдм
мимо: мимо
зачем: Зачем
наймете: Наймте
охрана: охрана
да: Да
кой: кой
пусть: пусть
возвращаться: возвращается
домой: домой
манти: манти
шуровать: шурует
какой: какие
деньга: деньги
добираться: добираться
подумать: подумали
конечно: конечно
посодействовать: посодействовать
еще: ещ
ктото: комуто
говорить: говорит
офицер: офицер
отдел: отдела
борьба: борьбе
коррупция: коррупцией
допустить: допустим
утрясти: утрясу
освобождение: освобождением
мантиец: мантийцу
равный: равно
где: Где
устраиваться: устраиваться
мелькать: Мелькать
уж: уж
больно: больно
заметный: заметен
попасться: Попадтся
враг: врагу
тогда: тогда
завертеться: завертится
представлять: Представляем
внимание: вниманию
похожий: похожие
отобрать: отобрали
схожий: схожую
название: названию
смысл: смысле
литература: литературу
надежда: надежде
предоставить: предоставить
читатель: читателей
больше: больше
вариант: вариантов
интересный: интересные
обсуждение: Обсуждение
собственный: собственные
оставить: Оставьте
главный: главных
указать: Укажите
конкретно: конкретно
понравиться: понравилось
считать: считаете
