заголовок: Заголовок
олег: Олег
данильченко: Данильченко
имперский: Имперский
вояж: вояж
читать: читать
онлайн: онлайн
бесплатно: бесплатно
адрес: Адрес
здесь: здесь
быть: быть
возможность: Возможность
весь: вс
текст: текст
электронный: электронной
книга: книге
совершенно: совершенно
целиком: целиком
полный: полную
версия: версию
в: в
некоторый: некоторые
случай: случае
присутствовать: присутствует
краткий: краткое
содержание: содержание
город: Город
м: М
спб: СПб
год: год
выпуск: выпуска
издательство: издательство
аста: АСТ
издательский: Издательский
дом: дом
ленинград: Ленинград
категория: категорию
боевой: Боевая
фантастика: фантастика
космический: космическая
на: на
русский: русском
язык: языке
описание: описание
произведение: произведении
предисловие: предисловие
а: а
так: так
же: же
отзыв: отзывы
посетитель: посетителей
доступный: доступны
портал: портале
библиотека: Библиотека
либ: Либ
кат: Кат
создать: создана
для: для
любитель: любителей
полистать: полистать
хороший: Хорошо
книжка: книжку
и: и
предлагать: Предлагаем
широкий: широкий
выбор: выбора
жанр: жанров
любовный: любовные
роман: романы
фэнтези: фэнтези
приключение: приключения
детектив: детективы
триллер: триллеры
эротика: эротика
документальный: документальные
научный: научные
юмористический: юмористические
анекдот: анекдоты
о: о
бизнес: бизнесе
проза: проза
детский: детские
сказка: сказки
религиия: религиии
новинка: новинки
православный: православные
старинный: старинные
про: про
компьютер: компьютеры
программирование: программирование
английский: английском
домоводство: домоводство
поэзия: поэзия
выбрав: Выбрав
по: по
душа: душе
вы: Вы
смочь: смогу
найти: найти
действительно: действительно
стоить: стоящие
насладиться: насладиться
погружение: погружением
мир: мир
воображение: воображения
прочувствовать: прочувствовать
переживание: переживания
герой: героях
или: или
узнать: Узнайте
себя: себя
чтото: чтото
новый: новые
совершить: совершить
внутренний: внутреннее
открытие: открытие
подробный: Подробная
информация: информацию
ознакомление: ознакомления
текущий: текущему
запрос: запросу
представить: представлен
низкий: Ниже
к: к
чтение: чтение
аннотация: аннотацию
зависеть: зависит
от: от
тот: тот
что: что
написать: напишите
сам: сами
автор: автора
если: Если
не: не
необходимый: необходимую
комментарий: комментарии
мы: Мы
постараться: постараемся
отыскать: отыскать
она: е
кто: Кто
фамилия: фамилию
как: как
звать: зовут
список: списком
его: его
серия: сериям
уважаемые: Уважаемые
правообладатель: правообладатели
размещать: размещать
наш: наших
сайт: сайте
у: у
любой: любой
зарегистрировать: зарегистрировано
пользователь: пользователя
ваш: ваши
опубликовать: опубликована
без: без
согласие: согласия
пожалуйста: пожалуйста
направить: направьте
жалоба: жалобу
заполните: заполните
форма: форму
обратный: обратной
связь: связи
течение: течение
час: часов
закрыть: закроем
доступ: доступ
нелегально: нелегально
разместить: размещенному
контент: контенту
разбить: разбитый
страница: страницу
система: систему
сохранение: сохранения
место: места
последний: последнее
прочитать: прочитанные
позволять: позволяют
с: с
удобство: удобством
необходимость: необходимости
каждый: каждый
раз: раз
заново: заново
искать: искать
остановиться: остановились
поставить: Поставьте
закладка: Закладка
момент: момент
перейти: перейти
который: которые
закончить: закончил
шрифт: Шрифт
интервал: Интервал
да: да
нет: нет
конечно: конечно
давно: давно
уже: уже
жить: живм
это: это
скорый: скорее
дань: дань
традиция: традиции
вот: Вот
ладно: Ладно
рассказать: рассказал
я: мной
свой: своего
рассказывать: рассказывать
мочь: могу
спрашивать: спрашивать
легче: легче
сказать: сказать
цивилизация: цивилизация
выйти: вышла
космос: космос
нууа: Нууу
протянуть: протянул
илья: Илье
слишком: слишком
громко: громко
пока: пока
осваивать: осваиваем
только: только
орбита: орбиту
планета: планеты
хотя: хотя
еще: ещ
высаживаться: высаживались
спутник: спутники
но: но
то: то
грех: грехом
пополам: пополам
посылать: Посылали
беспилотный: беспилотные
корабльавтомат: кораблиавтоматы
соседний: соседние
исследовательский: исследовательскими
миссия: миссиями
общийто: общемто
удаться: удалось
сделать: сделать
план: плана
освоение: освоения
кричать: кричим
бездна: бездну
вселенная: Вселенной
надежда: надежде
брат: братья
разум: разуму
услышать: услышат
результат: результат
нулевой: нулевой
прибедняться: прибедняйтесь
молодой: молодой
человек: люди
тоже: тоже
немало: немало
существовать: существуют
множество: множество
наблюдать: наблюдаемых
где: где
застрять: застряли
дикость: дикости
протяжение: протяжении
многий: многих
тысячелетие: тысячелетий
достаточно: достаточно
развитый: развитый
технический: техническом
находиться: находятся
он: он
сфера: сфере
влияние: влияния
империя: империи
кадар: Кадар
думать: думаете
бы: бы
войти: вошл
ее: е
состав: состав
кстати: Кстати
называться: называется
земля: Земле
взгляд: Взгляд
грег: Грег
расфокусироваться: расфокусировался
задуматься: задумался
через: Через
минута: минуту
очнуться: очнулся
каталог: каталогах
населить: населенной
разумный: разумными
под: под
такой: такое
название: названию
значить: значит
предел: пределах
ни: ни
один: одного
из: из
четыре: четырех
субъект: субъектов
содружество: Содружества
говорить: говорил
правда: правда
придумывать: придумывать
ход: ходу
этот: эту
история: историю
смысл: смысле
возмутиться: возмутился
знать: знаю
учесть: учтите
беседа: беседу
вестись: ведтся
протокол: протокол
фиксироваться: фиксируется
официально: официально
прослушивать: прослушивают
бессмысленный: бессмысленно
доктор: доктор
постучать: постучал
палец: пальцем
лоб: лбу
нейросеть: Нейросеть
ято: менято
поздний: позже
все: Вс
узнавать: узнаете
время: время
сейчас: Сейчас
несколько: несколько
другой: других
продолжить: продолжим
предположить: Предположим
тогда: Тогда
подождать: Подождите
док: док
перебить: перебил
иметь: имеют
официальный: официальный
характер: характер
при: при
тут: тут
правильно: Правильно
казаться: казалось
подобный: подобные
должный: должно
проводиться: проводиться
специально: специально
обучить: обученными
наподобие: наподобие
служба: служба
безопасность: безопасности
всякий: всяком
именно: именно
верно: Верно
илио: Илио
ведь: ведь
просто: просто
медик: медик
медицина: Медицина
второй: вторая
мой: моему
профессия: профессия
число: числе
первый: первую
очередь: очередь
офицер: офицер
сб: СБ
флот: флота
понимать: понимаете
какой: какая
штука: штука
корабль: корабле
большой: большому
счет: счту
заниматься: заниматься
нечего: нечем
экипаж: экипаже
проверить: проверенные
военный: военное
судно: судно
приходиться: приходится
совмещать: совмещать
чтобы: чтобы
чувствовать: чувствовать
нахлебник: нахлебником
больший: Большую
часть: часть
рабочий: рабочего
заведовать: заведую
медсекция: медсекцией
вспоминать: вспоминаю
абсолютно: абсолютно
законный: законно
попробуйте: Попробуйте
описать: описать
звездный: звездную
простить: Простите
вряд: вряд
ли: ли
специалист: специалист
ученый: учных
летать: летают
их: их
немного: немного
эра: эра
зачаточный: зачаточном
состояние: состоянии
известный: известно
давать: Давайте
программа: программе
школьный: школьного
курс: курса
вокруг: вокруг
звезда: звезды
называть: называют
солнце: Солнце
вращаться: вращается
девять: девять
третий: третья
удаление: удалению
луна: Луна
мнение: мнения
жизнь: жизнь
гипотеза: гипотезы
можно: можно
технология: технологии
доказать: доказать
спектральный: Спектральный
класс: класс
даже: даже
перечислить: перечислить
большинство: Большинство
забыть: забыть
помощник: помощник
допустить: допустим
верить: верю
оказаться: оказались
суук: Сууке
вздохнуть: вздохнул
поступить: поступим
случиться: случилось
за: за
начинать: начиная
событие: событий
предшествовать: предшествовали
появление: появлению
решать: решайте
делать: делать
далекий: дальше
илюха: Илюхой
плен: плена
чечня: Чечне
когда: Когда
рассказ: рассказ
долго: долго
сидеть: сидел
молча: молча
задумчиво: задумчиво
разглядывать: разглядывая
собеседник: собеседника
согласиться: согласитесь
пройти: пройти
ментоскопирование: ментоскопирование
вдруг: вдруг
спросить: спросил
жестко: жстко
посмотреть: посмотрел
глаз: глаза
куда: Куда
деться: делся
мягкий: мягкий
добродушный: добродушный
улыбчивый: улыбчивый
перед: перед
прожженный: прожжнный
офицербезопасник: офицербезопасник
представлять: Представляем
внимание: вниманию
похожий: похожие
отобрать: отобрали
схожий: схожую
литература: литературу
предоставить: предоставить
читатель: читателей
больше: больше
вариант: вариантов
интересный: интересные
обсуждение: Обсуждение
собственный: собственные
оставить: Оставьте
главный: главных
указать: Укажите
конкретно: конкретно
понравиться: понравилось
почему: почему
считать: считаете
