заголовок: Заголовок
олег: Олег
данильченко: Данильченко
имперский: Имперский
вояж: вояж
читать: читать
онлайн: онлайн
бесплатно: бесплатно
адрес: Адрес
здесь: здесь
быть: был
возможность: возможность
весь: вс
текст: текст
электронный: электронной
книга: книге
совершенно: совершенно
целиком: целиком
полный: полную
версия: версию
в: в
некоторый: некоторых
случай: случаем
присутствовать: присутствовали
краткий: краткое
содержание: содержание
город: Город
м: М
спб: СПб
год: год
выпуск: выпуска
издательство: издательство
аста: АСТ
издательский: Издательский
дом: дом
ленинград: Ленинград
категория: категорию
боевой: Боевая
фантастика: фантастика
космический: Космическая
на: на
русский: русском
язык: языке
описание: описание
произведение: произведении
предисловие: предисловие
а: а
так: так
же: же
отзыв: отзывы
посетитель: посетителей
доступный: доступны
портал: портале
библиотека: Библиотека
либ: Либ
кат: Кат
создать: создана
для: для
любитель: любителей
полистать: полистать
хороший: хорошая
книжка: книжку
и: и
предлагать: предлагал
широкий: широким
выбор: выбора
жанр: жанров
любовный: любовные
роман: романы
фэнтези: фэнтези
приключение: приключения
детектив: детективы
триллер: триллеры
эротика: эротика
документальный: документальные
научный: научные
юмористический: юмористические
анекдот: анекдоты
о: о
бизнес: бизнесе
проза: проза
детский: детские
сказка: сказки
религиия: религиии
новинка: новинки
православный: православные
старинный: старинные
про: про
компьютер: компьютеры
программирование: программирование
английский: английском
домоводство: домоводство
поэзия: поэзия
выбрав: Выбрав
по: по
душа: душе
вы: Вы
смочь: сможете
найти: нашли
действительно: действительно
стоить: стоит
насладиться: насладиться
погружение: погружением
мир: мир
воображение: воображения
прочувствовать: прочувствовать
переживание: переживания
герой: героях
или: или
узнать: Узнайте
себя: себе
чтото: чтото
новый: новые
совершить: совершить
внутренний: внутреннее
открытие: открытие
подробный: Подробная
информация: информацию
ознакомление: ознакомления
текущий: текущему
запрос: запросу
представить: представлен
низкий: Ниже
к: к
чтение: чтение
аннотация: аннотацию
зависеть: зависит
от: от
тот: тот
что: что
написать: напишите
сам: сам
автор: автора
если: если
не: не
необходимый: необходимую
комментарий: комментарии
мы: Мы
постараться: постараемся
отыскать: отыскать
она: е
кто: Кто
фамилия: фамилию
как: как
звать: зовут
список: списком
его: его
серия: сериям
уважаемые: Уважаемые
правообладатель: правообладатели
размещать: размещать
наш: нашем
сайт: сайте
у: у
любой: любую
зарегистрировать: зарегистрированного
пользователь: пользователя
ваш: ваши
опубликовать: опубликована
без: без
согласие: согласия
пожалуйста: пожалуйста
направить: направьте
жалоба: жалобу
заполните: заполните
форма: форму
обратный: обратной
связь: связи
течение: течение
час: часов
закрыть: закроем
доступ: доступ
нелегально: нелегально
разместить: размещенному
контент: контенту
разбить: разбитый
страница: страницу
система: Система
сохранение: сохранения
место: места
последний: последней
прочитать: прочитанные
позволять: позволяет
с: с
удобство: удобством
необходимость: необходимости
каждый: каждый
раз: раз
заново: заново
искать: искать
остановиться: остановились
поставить: поставить
закладка: Закладка
момент: момент
перейти: перейти
который: которой
закончить: закончили
шрифт: Шрифт
интервал: Интервал
вот: вот
хрен: хрен
ты: ты
угадать: угадал
буркнуть: буркнул
он: его
решить: решил
прикинуться: прикинуться
шланг: шлангом
типа: типа
тупой: тупой
понять: понял
пожать: Пожав
плечо: плечами
илюха: Илюха
кивнуть: кивнул
указать: Укажите
свой: сво
очередь: очередь
умерший: умершую
миска: Миска
жест: жестом
разрешить: разрешил
скушать: скушать
это: это
цветной: цветной
изобразить: изобразил
удивление: удивление
татуировать: татуированном
лицо: лице
потом: Потом
видимо: видимо
догадаться: догадавшись
арестант: арестант
понимать: понимаешь
вздохнуть: вздохнул
взять: взял
из: из
рука: руками
железный: железных
тормоз: тормоза
принести: принесенную
зеленый: зеленый
бурдомес: бурдомес
протянуть: протянул
илья: Илья
подозрительно: подозрительно
покоситься: покосился
стол: стол
где: Где
продолжать: продолжала
пузыриться: пузыриться
странный: странная
субстанция: субстанция
но: но
вопросительный: вопросительно
посмотреть: посмотрел
эскулап: эскулап
поощрительно: поощрительно
мол: мол
давать: давай
стесняться: стесняйся
ну: Ну
ничто: ничем
оставаться: оставалось
кроме: кроме
сделать: сделать
хотеть: хотел
мерзость: мерзость
вид: вид
отличаться: отличалась
вчерашний: вчерашней
однако: однако
вспомнить: вспомнив
хрень: хрень
хоть: хоть
мягко: мягко
говорить: говоря
невкусной: невкусной
отрава: отравой
являться: являлась
стать: стали
выпендриваться: выпендриваться
выпить: выпил
этот: этот
пластилиновый: пластилиновый
суп: суп
мда: Мда
чудо: чуда
произойти: произошло
вкус: вкус
тоже: тоже
измениться: изменился
продолжить: продолжил
вслух: вслух
наблюдение: наблюдения
уже: уже
пустой: пустую
посуда: посудой
рядом: рядом
бренный: бренными
останки: останками
первый: первой
дать: дал
отобрать: отобрали
сложить: сложил
пополам: пополам
слегка: слегка
хрустнуть: хрустнула
превратиться: превратилась
лепешка: лепешку
ктото: ктото
оторвать: оторвал
половина: половину
после: после
манипуляция: манипуляции
отломить: отломил
кусочек: кусочек
сунуть: сунув
рот: рот
приняться: принялся
жевать: жевать
проглотив: Проглотив
блин: блин
обратно: обратно
оторопелый: оторопело
знак: знаками
повторить: повторить
подвиг: подвиг
попробовать: попробовать
сжевать: сжевать
посудина: посудину
прийтись: Пришлось
повторять: повторять
делать: делали
когда: когда
бронированный: бронированная
образина: образина
серьезный: серьезным
дубец: дубцом
клешня: клешнях
оказаться: оказались
подобие: подобием
хлеб: хлеба
только: только
очень: очень
отдаленный: отдаленным
абсолютно: абсолютно
безвкусный: безвкусным
считать: считаете
остаток: остатки
привкус: привкуса
жижа: жижи
менее: менее
проглотить: проглотив
сказать: сказал
десерт: десерта
почувствовать: почувствовал
сытый: сыт
убедиться: убедившись
подопечный: подопечный
стрескать: стрескал
до: до
крошка: крошки
важный: важно
удалиться: удалился
за: За
дровосек: дровосека
податься: подался
выход: выход
жужжание: Жужжание
сервопривод: сервопривода
вновь: вновь
остаться: остался
один: один
мысль: Мысли
штука: штука
думать: думаете
передумать: передумано
они: они
наводить: наводят
тоска: тоску
бессильный: бессилен
чтолибо: чтолибо
предпринять: предпринять
поэтому: поэтому
заморачиваться: заморачиваться
повод: поводу
положение: положения
просто: просто
ждать: ждать
надо: надо
то: то
нет: нет
лучше: лучше
способ: способа
убить: убить
время: Время
чем: чем
сон: сон
заняться: занялся
более: более
пользоваться: пользоваться
пока: Пока
маленький: Мало
ли: ли
мочь: может
больше: больше
всласть: всласть
отоспаться: отоспаться
потянуться: Потянулись
день: дни
спать: спал
есть: ел
опять: опять
иногда: Иногда
появляться: появлялся
осматривать: осматривал
колено: колено
понятный: понятные
да: да
дуболом: Дуболомы
приносить: приносили
баланда: баланду
съедобный: съедобной
прошествие: прошествии
два: Два
неделя: недель
три: трех
меньше: меньше
местный: местный
снять: снял
гипс: гипс
велеть: велел
начинать: начинать
нагружать: нагружать
нога: ногу
обрадоваться: обрадовался
лежать: лежать
надоесть: надоело
еще: ещ
большой: больше
поедать: поедать
ежедневно: ежедневно
вприкуску: вприкуску
ходить: Ходить
угол: угол
сначала: сначала
больно: больно
боль: боль
пройти: прошла
правда: правда
желать: желало
нормально: нормально
гнуться: гнуться
либо: либо
повреждение: повреждения
слишком: слишком
оно: оно
сгибаться: сгибаться
таки: таки
расходиться: расходится
начать: Начал
функционировать: функционировать
вскоре: вскоре
ходитьто: ходитьто
особо: особо
негде: негде
тогда: тогда
придумать: придумал
занятие: занятие
восстанавливать: восстанавливать
мышечный: мышечную
инвентарь: инвентаря
хватать: хватало
чтобы: Чтобы
качать: качать
пресс: пресс
отжиматься: отжиматься
пол: полу
махать: махать
проделывать: проделывая
нехитрый: нехитрый
комплекс: комплекс
рукопашка: рукопашке
много: много
идти: Шли
медленно: медленно
питание: питание
отдых: отдых
упражнение: упражнения
дело: дело
почти: почти
восстановить: восстановил
прийти: пришли
вломиться: вломились
камера: камеру
тычок: тычками
погнать: погнали
узник: узника
коридор: коридорам
приблизительно: приблизительно
минута: минут
пять: пять
знакомый: знакомый
допросный: допросной
весело: весело
бликовать: бликуя
голый: голый
череп: черепом
встретить: встретил
старый: старый
лысый: лысому
стильный: стильный
оригинал: оригинал
радушный: радушным
пригласить: пригласил
присаживаться: присаживаться
стул: Стул
всего: всего
прикрутить: прикрученный
именно: именно
нем: нм
восседать: восседал
очнуться: очнулся
указывать: указывал
спина: спиной
маячить: маячили
двое: двое
ларец: ларца
хотеться: хотелось
садиться: садиться
трон: трон
пристегивать: Пристгивать
бронировать: бронированные
перец: перцы
помещение: помещения
выйти: вышли
появиться: появился
ранее: ранее
видеть: виденный
человек: человек
экстравагантный: экстравагантной
наружность: наружности
смысл: смысле
волос: волосы
голова: голове
бровь: бровей
ресница: ресницами
наблюдаться: наблюдалось
демонстративно: демонстративно
уставиться: уставился
молчать: молча
разглядывать: разглядывая
продолжаться: продолжалось
несколько: несколько
показать: показал
встать: встать
раздеться: раздеться
выполнять: выполнять
явственно: явственно
напрячься: напряглись
готовый: готовые
секунда: секунду
пресечь: пресечь
сопротивление: сопротивление
стоять: стоял
гаврик: гаврик
бесцеремонно: бесцеремонно
вертеть: вертел
ощупывать: ощупывал
представлять: Представляем
внимание: вниманию
похожий: похожие
схожий: схожую
название: названию
литература: литературу
надежда: надежде
предоставить: предоставить
читатель: читателей
вариант: вариантов
интересный: интересные
обсуждение: Обсуждение
собственный: собственные
мнение: мнения
оставить: Оставьте
главный: главных
конкретно: конкретно
понравиться: понравилось
почему: почему
