заголовок: Заголовок
олег: Олег
данильченко: Данильченко
имперский: Имперский
вояж: вояж
читать: читать
онлайн: онлайн
бесплатно: бесплатно
адрес: Адрес
здесь: здесь
быть: были
возможность: возможности
весь: Все
текст: Текст
электронный: электронной
книга: книге
совершенно: совершенно
целиком: целиком
полный: полную
версия: версию
в: в
некоторый: некоторых
случай: случаях
присутствовать: присутствует
краткий: краткое
содержание: содержание
город: Город
м: М
спб: СПб
год: год
выпуск: выпуска
издательство: издательство
аста: АСТ
издательский: Издательский
дом: дом
ленинград: Ленинград
категория: категорию
боевой: боевым
фантастика: фантастика
космический: Космическая
на: на
русский: русском
язык: языке
описание: описание
произведение: произведении
предисловие: предисловие
а: а
так: так
же: же
отзыв: отзывы
посетитель: посетителей
доступный: доступны
портал: портале
библиотека: Библиотека
либ: Либ
кат: Кат
создать: создана
для: для
любитель: любителей
полистать: полистать
хороший: Лучшая
книжка: книжку
и: и
предлагать: Предлагаем
широкий: широкий
выбор: выбора
жанр: жанров
любовный: любовные
роман: романы
фэнтези: фэнтези
приключение: приключения
детектив: детективы
триллер: триллеры
эротика: эротика
документальный: документальные
научный: научные
юмористический: юмористические
анекдот: анекдоты
о: о
бизнес: бизнесе
проза: проза
детский: детские
сказка: сказки
религиия: религиии
новинка: новинки
православный: православные
старинный: старинные
про: про
компьютер: компьютеры
программирование: программирование
английский: английском
домоводство: домоводство
поэзия: поэзия
выбрав: Выбрав
по: по
душа: душе
вы: Вы
смочь: смог
найти: нашл
действительно: действительно
стоить: стоящие
насладиться: насладиться
погружение: погружением
мир: мир
воображение: воображения
прочувствовать: прочувствовать
переживание: переживания
герой: героях
или: или
узнать: Узнайте
себя: себе
чтото: Чтото
новый: новые
совершить: совершит
внутренний: Внутренний
открытие: открытие
подробный: Подробнее
информация: информацию
ознакомление: ознакомления
текущий: текущему
запрос: запросу
представить: представлен
низкий: Ниже
к: к
чтение: чтение
аннотация: аннотацию
зависеть: зависит
от: от
тот: тот
что: что
написать: напишите
сам: самом
автор: автора
если: Если
не: не
необходимый: необходимо
комментарий: комментарии
мы: Мы
постараться: постараемся
отыскать: отыскать
она: е
кто: Кто
фамилия: фамилию
как: как
звать: зовут
список: списком
его: его
серия: сериям
уважаемые: Уважаемые
правообладатель: правообладатели
размещать: размещать
наш: наша
сайт: сайте
у: у
любой: любых
зарегистрировать: зарегистрированного
пользователь: пользователя
ваш: ваши
опубликовать: опубликована
без: без
согласие: согласия
пожалуйста: пожалуйста
направить: направьте
жалоба: жалобу
заполните: заполните
форма: форму
обратный: обратной
связь: связи
течение: течение
час: часов
закрыть: закроем
доступ: доступ
нелегально: нелегально
разместить: размещенному
контент: контенту
разбить: разбитый
страница: страницу
система: системы
сохранение: сохранения
место: места
последний: последней
прочитать: прочитанные
позволять: позволяет
с: со
удобство: удобством
необходимость: необходимости
каждый: каждый
раз: раз
заново: заново
искать: искать
остановиться: остановились
поставить: Поставьте
закладка: Закладка
момент: момент
перейти: перейти
который: который
закончить: закончили
шрифт: Шрифт
интервал: Интервал
пилс: Пилса
именно: Именно
он: ему
мочь: может
какойнибудь: какуюнибудь
пакость: пакость
устроить: устроить
поэтому: Поэтому
мониторить: мониторить
где: где
когда: когда
принятый: Принято
кстати: кстати
сейчас: сейчас
столовая: столовой
судить: Судя
положение: положению
принимать: принимать
пища: пищу
напоминать: Напоминаю
босс: босс
ты: Ты
также: также
усиленно: усиленно
питаться: питаться
изменение: Изменения
тело: тела
требовать: требуют
строительный: строительного
материал: материала
жоривый: Жориво
поривый: пориво
это: Это
очень: очень
здоривый: здориво
пропеть: пропел
илюха: Илюха
ускорять: ускоряя
шаг: шаг
людный: людно
гул: Гул
голос: голосов
висеть: висел
воздух: воздухе
улей: улье
лео: Лео
илья: Илья
оглядеться: огляделся
увидеть: увидел
угловой: углового
стол: стола
махать: машет
норк: Норк
привет: Привет
поздороваться: поздоровался
присесть: присел
рядом: рядом
здорово: Здорово
дружище: дружище
ничто: Ничего
пока: пока
считать: считаете
очередной: очередной
выходка: выходки
уже: уже
успеть: успел
натворить: натворить
избить: избили
толпа: толпой
курсант: курсант
но: но
камера: камеры
слежение: слежения
зафиксировать: зафиксировали
видимо: Видимо
мертвый: мртвую
зона: зону
почему: почему
видеофайл: видеофайл
предоставить: предоставить
наверное: Наверное
сзади: сзади
голова: голове
ударить: ударили
потом: Потом
отпинать: отпинали
сильно: Сильно
да: Да
нет: нет
ну: Ну
даже: даже
прекрасный: прекрасным
такой: такой
недалекий: недалкий
надо: Надо
чтобы: чтобы
тут: тут
достать: достал
тогда: Тогда
ход: ход
настать: настанет
задумать: задумал
рано: рано
еще: ещ
говорить: говорили
просто: просто
ждать: ждать
когданибудь: Когданибудь
ошибка: ошибку
время: временем
разговор: разговора
продолжать: продолжал
работать: работать
ложка: ложкой
голод: голод
давать: давал
знать: знал
много: много
ресурс: ресурсов
потреблять: потребляла
модификация: модификация
ткань: тканей
вот: Вот
метать: мечешь
поразиться: поразился
риго: Риго
куда: Куда
лезть: лезет
удивляться: удивляюсь
смутиться: смутился
проголодаться: проголодался
спасти: спасу
поторапливаться: поторапливайся
построение: Построение
опоздать: опоздаем
пропыхтеть: пропыхтел
допивать: допивая
второй: второй
бокал: бокал
сок: сока
готовый: готов
пойти: пошли
проходить: проходило
спортивный: спортивном
зал: зале
помещение: помещение
огромный: огромных
размер: размеров
обычный: обычные
день: дни
оно: оно
использоваться: использовалось
тренировка: тренировок
нем: нм
можно: можно
создавать: создавать
угодно: угодно
вплоть: вплоть
до: до
сложный: сложнейших
полоса: полос
препятствие: препятствиями
отработка: отработки
слаженность: слаженности
взаимодействие: взаимодействия
пехотный: пехотных
группа: группа
соревнование: Соревнования
тактика: тактике
господь: Господа
будущий: будущие
офицер: офицеры
приветствовать: Приветствуем
территория: территории
учебный: учебного
центр: центрах
слово: слова
начать: начнм
свой: свое
выступление: выступление
руководитель: руководитель
этот: этих
богадельня: богадельни
сделать: сделали
правильный: правильный
научиться: научитесь
мечтать: мечтать
человек: человек
иметь: Имея
желание: желание
стать: стать
специалист: специалистом
школа: школе
являться: является
хоть: хоть
военный: военные
учреждение: учреждением
посему: Посему
ее: е
действовать: действуют
закон: законы
правило: правил
ношение: Ношение
гражданский: гражданской
одежда: одежды
строго: строго
запретить: запрещено
распорядок: распорядок
должный: должен
выполняться: выполняться
неукоснительно: неукоснительно
дисциплина: дисциплины
прежде: прежде
за: за
нарушение: нарушения
налагаться: налагаться
взыскание: взыскания
вид: виде
отказ: отказа
увольнение: увольнении
три: три
отчисляться: отчисляется
курс: курсы
обучаться: обучаться
другой: другого
подобный: подобной
деньга: Деньги
внести: внесенные
обучение: обучением
возвращаться: возвращаются
мой: мой
заместитель: заместитель
зачитать: зачитает
присяга: присяги
из: из
выходить: выходил
строй: строя
после: После
командир: командиры
разделить: разделят
шесть: шесть
нужный: нужно
получать: получает
дополнительный: дополнительное
под: под
разгон: разгоном
вестись: ведутся
только: только
скорость: скорость
ведь: ведь
качество: качества
установить: установленных
нейросеть: нейросеть
разный: разное
оцениваться: оцениваться
насколько: насколько
хорошо: хорошо
применяться: применяются
дело: деле
усвоенные: усвоенные
знание: знания
значить: значит
учитываться: учитываться
глубина: глубина
усвоить: усвоенного
известный: известно
быстро: быстро
проскочить: проскочить
какойлибо: какойлибо
аспект: аспект
изучить: изучив
лишь: лишь
поверхностно: поверхностно
получить: получил
допуск: допуск
управление: управлению
более: более
совершенный: совершенным
вооружение: вооружением
впоследствии: впоследствии
я: я
уверять: уверяю
сказаться: скажется
рекомендовать: рекомендую
пренебрегать: пренебрегать
выйти: выйти
стена: стен
пусть: пусть
большой: большом
звание: звании
зато: зато
высокий: высшего
остальной: остальные
приложиться: приложится
рассказать: расскажут
непосредственный: непосредственные
собраться: собрались
показаться: показался
вычурнопафосный: вычурнопафосным
коротко: коротко
то: то
смысл: смысле
примерно: примерно
пропить: пропьм
флот: флот
опозорить: опозорим
общий: общем
блаблаблабла: блаблаблабла
ожидать: ожидал
затем: Затем
середина: середину
импровизированный: импровизированного
плац: плаца
произносить: произносили
положенный: положенные
нерушимость: нерушимости
граница: границ
мирный: мирном
сон: сне
смерть: смерти
слава: славу
ахинея: ахинее
повторять: повторял
оттарабанить: оттарабанив
положить: положенное
лычко: лычку
рукав: рукав
значок: значок
принадлежность: принадлежности
произойти: произошло
начало: начале
потому: потому
пилот: пилотов
стоять: стоять
первый: первым
шеренга: шеренге
прийтись: пришлось
долго: долго
бред: бред
продолжаться: продолжалось
двадцать: двадцать
минута: минуты
теперь: теперь
всегда: всегда
точно: точно
цифра: цифры
постоянно: постоянно
периферия: периферии
зрение: зрения
представлять: Представляем
внимание: вниманию
похожий: похожие
отобрать: отобрали
схожий: схожую
название: названию
литература: литературу
надежда: надежде
читатель: читателей
больше: больше
вариант: вариантов
интересный: интересные
обсуждение: Обсуждение
собственный: собственные
мнение: мнения
оставить: Оставьте
думать: думаете
главный: главных
указать: Укажите
конкретно: конкретно
понравиться: понравилось
