заголовок: Заголовок
олег: Олег
данильченко: Данильченко
имперский: Имперский
вояж: вояж
читать: читать
онлайн: онлайн
бесплатно: бесплатно
адрес: Адрес
здесь: Здесь
быть: будешь
возможность: Возможность
весь: вс
текст: текстом
электронный: электронной
книга: книге
совершенно: совершенно
целиком: целиком
полный: полную
версия: версию
в: в
некоторый: некоторых
случай: случае
присутствовать: присутствует
краткий: краткое
содержание: содержание
город: Город
м: М
спб: СПб
год: год
выпуск: выпуска
издательство: издательство
аста: АСТ
издательский: Издательский
дом: дом
ленинград: Ленинград
категория: категорию
боевой: боевую
фантастика: фантастика
космический: Космическая
на: на
русский: русском
язык: язык
описание: описание
произведение: произведении
предисловие: предисловие
а: а
так: так
же: же
отзыв: отзывы
посетитель: посетителей
доступный: доступны
портал: портале
библиотека: Библиотека
либ: Либ
кат: Кат
создать: создана
для: для
любитель: любителей
полистать: полистать
хороший: хорошо
книжка: книжку
и: и
предлагать: Предлагаем
широкий: широкий
выбор: выбора
жанр: жанров
любовный: любовные
роман: романы
фэнтези: фэнтези
приключение: приключения
детектив: детективы
триллер: триллеры
эротика: эротика
документальный: документальные
научный: научные
юмористический: юмористические
анекдот: анекдоты
о: о
бизнес: бизнесе
проза: проза
детский: детские
сказка: сказки
религиия: религиии
новинка: новинки
православный: православные
старинный: старинные
про: про
компьютер: компьютеры
программирование: программирование
английский: английском
домоводство: домоводство
поэзия: поэзия
выбрав: Выбрав
по: по
душа: душе
вы: Вы
смочь: сможете
найти: найти
действительно: действительно
стоить: стоящие
насладиться: насладиться
погружение: погружением
мир: мир
воображение: воображения
прочувствовать: прочувствовать
переживание: переживания
герой: героях
или: или
узнать: Узнайте
себя: себя
чтото: чегото
новый: новые
совершить: совершить
внутренний: внутреннее
открытие: открытие
подробный: Подробная
информация: информацию
ознакомление: ознакомления
текущий: текущему
запрос: запросу
представить: представлен
низкий: Ниже
к: К
чтение: чтение
аннотация: аннотацию
зависеть: зависит
от: от
тот: тому
что: что
написать: напишите
сам: самом
автор: автора
если: Если
не: не
необходимый: необходимую
комментарий: комментарии
мы: Мы
постараться: постараемся
отыскать: отыскать
она: она
кто: кто
фамилия: фамилию
как: как
звать: зовут
список: списком
его: его
серия: сериям
уважаемые: Уважаемые
правообладатель: правообладатели
размещать: размещать
наш: наше
сайт: сайте
у: у
любой: любой
зарегистрировать: зарегистрированного
пользователь: пользователя
ваш: ваши
опубликовать: опубликована
без: без
согласие: согласия
пожалуйста: пожалуйста
направить: направьте
жалоба: жалобу
заполните: заполните
форма: форму
обратный: обратной
связь: связи
течение: течение
час: часов
закрыть: закроем
доступ: доступ
нелегально: нелегально
разместить: размещенному
контент: контенту
разбить: разбитый
страница: страницу
система: Система
сохранение: сохранения
место: места
последний: последнее
прочитать: прочитанные
позволять: позволяет
с: со
удобство: удобством
необходимость: необходимости
каждый: каждый
раз: раз
заново: заново
искать: искать
остановиться: остановились
поставить: Поставьте
закладка: Закладка
момент: момент
перейти: перейти
который: которые
закончить: закончили
шрифт: Шрифт
интервал: Интервал
рукопашный: рукопашным
комплекс: комплекс
еще: ещ
проще: проще
курсант: курсант
должный: должны
продемонстрировать: продемонстрировать
движение: движений
никакой: Никаких
спарринг: спарринга
чисто: чисто
отработать: отработать
пригласить: приглашенный
специалист: специалист
оценивать: оценивает
поскольку: поскольку
дисциплина: дисциплина
непрофильная: непрофильная
особо: особо
придираться: придираются
правда: Правда
этот: этого
заметить: заметит
ошибка: ошибки
согласный: согласен
оценка: оценкой
действие: действии
экзаменатор: экзаменатор
мочь: может
проверить: проверить
навык: навыки
лично: лично
экзаменовать: экзаменуемый
через: через
минута: минуту
после: после
начало: начала
оставаться: остается
нога: ногах
он: он
ставить: ставят
зачет: зачт
но: но
такой: такие
случаться: случается
крайне: крайне
редко: редко
за: за
рукопашка: рукопашку
илья: Илья
переживать: переживал
ребята: ребят
уже: уже
достаточно: достаточно
натаскать: натаскали
даже: даже
кнопка: кнопки
энци: Энци
какойлибо: какихлибо
проблема: проблема
отмахаться: отмахаться
паратройка: парытройки
хулиган: хулиганов
вот: вот
повод: поводу
пехотный: пехотного
бой: бой
сомнение: сомнениями
маленький: маленькая
их: их
команда: команда
один: одного
человек: человека
меньше: меньше
близняшками: близняшками
они: им
кроме: кроме
легкий: лгкой
вооружение: вооружения
ничто: ничего
дать: дашь
ну: Ну
уж: уж
больно: больно
миниатюрный: миниатюрные
девчонка: девчонки
думать: думаете
энди: Энди
однако: однако
сравнение: сравнению
мелюзга: мелюзгой
вполне: вполне
рослый: рослой
скафандр: скафандр
подобрать: подобрать
целый: целая
дед: дед
обещать: обещал
чтонибудь: чтонибудь
придумать: придумаешь
там: Там
легкое: лгкое
удаться: удастся
хотя: Хотя
размышлять: размышлял
землянин: землянин
это: это
выход: выход
из: из
создаться: создавшейся
ситуация: ситуации
ведь: ведь
стопудовый: стопудово
напялить: напялят
максимум: максимуму
мощный: помощнее
потяжелее: потяжелее
потолще: потолще
да: Да
вооружатся: вооружатся
самый: самым
баловать: балуй
представлять: Представляем
шагать: шагающие
танк: танки
бы: бы
наверное: наверное
сделать: сделал
зевран: Зевран
время: время
тренировка: тренировках
настаивать: настаивал
почемуто: почемуто
использование: использовании
больше: больше
защита: защиты
чуть: чуть
ли: ли
сила: силой
заставлять: заставлял
изучать: изучать
подрывной: подрывное
дело: деле
зачем: Зачем
мина: мин
взрывча: взрывча
стоп: СТОП
намек: намк
точно: точно
оно: оно
поверхность: поверхности
лежать: лежит
золотой: Золотой
ты: ты
мой: мой
старик: старик
где: где
коньякто: коньякуто
взять: взять
чтобы: чтобы
отблагодарить: отблагодарить
я: я
остолоп: остолоп
прямой: прямым
указывать: указывают
тупить: туплю
ладный: Ладно
исходить: исходить
вновь: вновь
открыться: открывшихся
обстоятельство: обстоятельств
то: то
получаться: получается
маневренный: маневренный
минирование: минирование
поступим: поступим
надо: надо
долго: долго
сидеть: сидел
комп: компом
рисовать: рисуя
схема: схемы
пытаться: пытаясь
продумать: продумать
наперед: наперд
комбинация: комбинации
можно: можно
применить: применить
ни: ни
извращаться: извращался
искин: ИскИн
при: при
создание: создании
полигон: полигона
только: только
предугадать: предугадать
равный: равно
нельзя: нельзя
тяжелый: тяжлую
сердце: сердцем
раздираемый: раздираемый
отправиться: отправился
спать: спать
шконка: шконке
ворочаться: ворочался
боку: боку
бок: бок
продолжать: продолжайте
завтрашний: завтрашнем
день: дне
пока: пока
забыться: забылся
тревожный: тревожным
сон: сне
тащить: тащил
раненый: раненого
демьяненко: Демьяненко
чеченский: чеченские
боевик: боевики
преследовать: преследовали
одеть: одеты
теперь: теперь
броня: броню
поголовно: поголовно
лысый: лысыми
бровь: бровей
ресница: ресниц
глухой: Глухие
тактический: тактические
шлем: шлемы
давать: дает
увидеть: увидеть
откудато: откудато
знать: знал
стрелять: стрелял
верный: верного
абакан: абакана
заканчиваться: заканчивались
патрон: патроны
помогать: помогало
пуля: пули
рикошетили: рикошетили
визг: визгом
причинять: причиняя
капля: капли
урон: урона
проснуться: Проснулся
илюха: Илюху
холодный: холодном
пот: поту
дико: дико
озираться: озираясь
сторона: сторонам
потом: потом
приходить: приходил
контрастный: контрастный
душ: душ
заставить: заставил
почувствовать: почувствовать
значительно: значительно
появиться: Появилось
чувство: чувство
голод: голода
пора: пора
столовая: столовую
ждать: ждали
сбор: сборе
народ: Народ
унылый: унылыми
лицо: лицами
вяло: вяло
ковыряться: ковырялся
свой: своими
тарелка: тарелках
ээээто: Ээээто
упаднический: упаднические
настроение: настроения
весело: весело
гаркнуть: гаркнул
решать: решают
первый: первые
пнут: пнут
ворота: ворота
послышаться: послышалась
ехидный: ехидная
реплика: реплика
стол: столом
заседать: заседала
компания: компания
пилс: Пилса
пнуть: пнут
скорее: скорее
ктонибудь: когонибудь
изза: изза
парировать: парировал
нет: нет
папашка: папашка
отмазать: отмажет
остальной: остальные
кандидат: кандидаты
почему: почему
удивиться: удивились
ж: ж
просто: просто
балбес: балбеса
выбрать: выберут
жопку: жопку
лизать: лизать
глядишь: глядишь
замолвить: замолвит
словечко: словечками
чей: чей
длинный: длинным
шелковый: шлковым
вырвать: вырву
твой: твой
поганый: поганый
прошипеть: прошипел
вега: Вега
багровея: багровея
смотреть: Смотри
надорваться: надорвись
когда: когда
вырывать: вырывать
засмеяться: засмеялся
поворачиваться: поворачиваясь
голова: головы
повесить: повесили
орел: Орлы
орлица: орлицы
спросить: спросила
беррана: Беррана
вечный: Вечно
непонятный: непонятными
больший: большие
гордый: гордые
очень: очень
красивый: красивые
птица: птицы
водиться: водятся
родина: родине
сильный: сильной
опасный: опасной
хм: Хм
чувствовать: чувствовать
усомниться: усомнилась
девушка: девушка
зря: зря
тренироваться: тренировались
тоже: тоже
мандраж: мандраж
потряхивать: потряхивал
показывать: показывать
товарищ: Товарищи
уверенность: уверенность
хоть: хоть
какойто: какоето
преимущество: преимущество
внимание: вниманию
похожий: похожие
отобрать: отобрали
схожий: схожую
название: названию
смысл: смысле
литература: литературу
надежда: надежде
предоставить: предоставить
читатель: читателей
вариант: вариантов
интересный: интересные
обсуждение: Обсуждение
собственный: собственные
мнение: мнения
оставить: Оставьте
главный: главных
указать: Укажите
конкретно: конкретно
понравиться: понравилось
считать: считаете
