заголовок: Заголовок
олег: Олег
данильченко: Данильченко
имперский: Имперский
вояж: вояж
читать: читать
онлайн: онлайн
бесплатно: бесплатно
адрес: Адрес
здесь: Здесь
быть: было
возможность: возможностями
весь: вс
текст: текст
электронный: электронной
книга: книге
совершенно: совершенно
целиком: целиком
полный: полная
версия: версия
в: в
некоторый: некоторых
случай: случаях
присутствовать: присутствует
краткий: краткое
содержание: содержание
город: Город
м: М
спб: СПб
год: год
выпуск: выпуска
издательство: издательство
аста: АСТ
издательский: Издательский
дом: дом
ленинград: Ленинград
категория: категорию
боевой: боевые
фантастика: фантастика
космический: космических
на: на
русский: русском
язык: языком
описание: описание
произведение: произведении
предисловие: предисловие
а: а
так: так
же: же
отзыв: отзывы
посетитель: посетителей
доступный: доступны
портал: портале
библиотека: Библиотека
либ: Либ
кат: Кат
создать: создана
для: для
любитель: любителей
полистать: полистать
хороший: хорошую
книжка: книжку
и: и
предлагать: Предлагаем
широкий: широкий
выбор: выбора
жанр: жанров
любовный: любовные
роман: романы
фэнтези: фэнтези
приключение: приключения
детектив: детективы
триллер: триллеры
эротика: эротика
документальный: документальные
научный: научные
юмористический: юмористические
анекдот: анекдоты
о: о
бизнес: бизнесе
проза: проза
детский: детские
сказка: сказки
религиия: религиии
новинка: новинки
православный: православные
старинный: старинные
про: про
компьютер: компьютер
программирование: программирование
английский: английском
домоводство: домоводство
поэзия: поэзия
выбрав: Выбрав
по: по
душа: душе
вы: Вы
смочь: сможет
найти: нашли
действительно: действительно
стоить: стоящие
насладиться: насладиться
погружение: погружением
мир: мир
воображение: воображения
прочувствовать: прочувствовать
переживание: переживания
герой: героях
или: или
узнать: Узнайте
себя: себя
чтото: чтото
новый: новые
совершить: совершить
внутренний: внутреннее
открытие: открытие
подробный: Подробная
информация: информацию
ознакомление: ознакомления
текущий: текущему
запрос: запросу
представить: представьте
низкий: Ниже
к: к
чтение: чтение
аннотация: аннотацию
зависеть: зависит
от: от
тот: том
что: что
написать: напишите
сам: сами
автор: автора
если: если
не: не
необходимый: необходимую
комментарий: комментарии
мы: Мы
постараться: постараемся
отыскать: отыскать
она: она
кто: Кто
фамилия: фамилию
как: как
звать: зовут
список: списком
его: его
серия: сериям
уважаемые: Уважаемые
правообладатель: правообладатели
размещать: размещать
наш: нашем
сайт: сайте
у: у
любой: любой
зарегистрировать: зарегистрированного
пользователь: пользователя
ваш: ваши
опубликовать: опубликована
без: без
согласие: согласия
пожалуйста: пожалуйста
направить: направьте
жалоба: жалобу
заполните: заполните
форма: форму
обратный: обратной
связь: связи
течение: течение
час: часов
закрыть: закроем
доступ: доступ
нелегально: нелегально
разместить: размещенному
контент: контенту
разбить: разбитый
страница: страницу
система: Система
сохранение: сохранения
место: места
последний: последний
прочитать: прочитанные
позволять: позволяет
с: с
удобство: удобством
необходимость: необходимости
каждый: каждая
раз: Раз
заново: заново
искать: искать
остановиться: остановившимся
поставить: Поставьте
закладка: Закладка
момент: момента
перейти: перейти
который: которую
закончить: закончили
шрифт: Шрифт
интервал: Интервал
следующий: следующее
неделя: неделя
пролететь: пролетела
бешеный: бешеном
темп: темпе
илья: Илья
еще: ещ
никогда: никогда
жизнь: жизни
уставать: уставал
только: только
он: него
освобождаться: освобождался
из: из
рука: руку
черим: Черима
сразу: сразу
попадать: попадал
цепкий: цепкие
лапка: лапки
дедушка: дедушки
зева: Зевы
уж: уж
резвиться: резвился
мама: мама
горевать: горюй
тренировка: Тренировки
приостанавливаться: приостанавливались
еда: еду
комплекс: Комплекс
рукопашка: рукопашке
иметься: имелся
база: базы
предоставлять: предоставляемых
школа: школы
дед: Дед
забраковать: забраковал
обозвать: обозвав
танец: танцами
нет: нет
сказать: сказала
это: это
туфта: туфта
просто: просто
там: Там
учить: учили
короче: Короче
урезанный: урезанная
вот: Вот
недоставать: недостающее
вдалбливать: вдалбливал
эффектный: эффектные
прием: прием
приказать: приказал
забыть: забыть
мнение: мнения
они: их
девок: девок
впечатлить: впечатлить
можно: можно
натаскивать: натаскивал
совсем: совсем
другой: другая
стиль: стиле
показывать: показывал
иметь: имеет
основа: основе
лишь: лишь
разница: разницей
заточить: заточен
уничтожение: уничтожение
противник: противника
короткий: короткое
скупой: скупые
движение: движении
порой: порой
незаметный: незаметными
непосвященный: непосвященного
но: но
эффективней: эффективней
строиться: строилось
встречный: встречном
никакой: никаких
блок: блоков
размахивание: размахиваний
кунфу: кунфу
слово: слов
объяснить: объяснить
работа: работа
болевой: болевым
уязвимый: уязвимым
точка: точкам
бить: Бьт
ктото: ктото
кулак: кулаком
голова: голове
чуть: чуть
подправить: подправив
разворачивать: разворачиваете
чутьчуть: чутьчуть
затем: затем
быстрый: быстрый
удар: удар
подмышечный: подмышечную
впадина: впадину
сдвинуться: сдвинулись
оседать: оседает
куль: кулем
сердце: сердцем
происходить: происходит
настолько: настолько
быстро: быстро
окружать: окружающее
специалист: специалисты
ничто: ничего
понять: понял
кроме: Кроме
ножевой: ножевой
бой: бой
выясниться: выяснилось
когдато: когдато
пока: пока
изобрести: изобретены
специальный: специальная
средство: средства
ведение: ведения
внутри: внутри
корабль: кораблей
при: при
абордаж: абордаже
использовать: использовать
старый: старые
добрый: добрые
нож: нож
ну: Ну
точный: точным
такой: такие
немаловажно: немаловажно
этот: этой
клинок: клинок
вообще: вообще
напоминать: напоминали
холодный: холодное
оружие: оружия
представлять: Представляем
илюха: Илюха
услышать: услышав
приходиться: Приходится
видеть: видеть
бензопила: бензопиле
теперь: теперь
кромка: кромке
двигаться: движется
режущий: режущий
элемент: элемент
конечно: конечно
цепь: цепь
наподобие: наподобие
гибкий: гибкой
струна: струны
невооруженный: невооруженного
глаз: глаза
зазубрина: зазубринами
материал: материал
сделать: сделана
способный: способен
резать: резать
очень: очень
многое: многое
скафандр: скафандра
например: например
вскрывать: вскрывает
консервный: консервные
банк: банки
ножичек: ножичками
прийтись: пришлось
размахивать: размахивать
изучать: изучая
премудрость: премудрости
абордажный: абордажного
заявить: заявил
стрелять: стрелять
дурак: дурак
работать: работать
ручка: ручками
помнить: помнят
конец: концу
месяц: месяц
ди: Ди
сообщить: сообщила
выйти: вышла
рабочий: рабочий
режим: режим
изменение: Изменение
тело: тела
завершить: завершено
главный: главных
обрадовать: обрадовала
оказаться: оказалось
показатель: показатели
улучшение: улучшения
интеллект: интеллект
память: память
восприятие: восприятия
возрасти: возросли
первый: первый
двадцать: двадцать
единица: единиц
остальной: остальные
два: две
прибавить: прибавили
десять: десять
общий: общем
получиться: получилось
равный: равен
триста: тремстам
семнадцать: семнадцати
сто: ста
шесть: шести
соответственно: соответственно
одиннадцать: одиннадцати
прочий: прочего
добавить: добавила
благодаря: благодаря
вовремя: вовремя
включить: включенной
функция: функций
самообучение: самообучения
мочь: может
усовершенствовать: усовершенствовать
за: за
счет: счт
резерв: резервы
организм: организма
какой: какого
вид: виду
симбионт: симбионт
соседка: соседка
похоже: похоже
знать: знает
большой: большом
всякий: всяком
слышать: слышал
активироваться: активировался
временной: временного
увеличение: увеличения
порядок: порядка
правда: Правда
ооочень: ооочень
временно: временно
всего: всего
три: три
максимум: максимум
пять: пять
минута: минута
грозить: грозит
серьезный: серьезным
откат: откатом
впоследствии: впоследствии
летальный: летально
жутко: жутко
неприятный: неприятные
ощущение: ощущения
гарантировать: гарантированы
рекомендоваться: рекомендуется
либо: либо
пользоваться: пользоваться
исключительно: исключительно
особый: особых
непродолжительный: непродолжительный
срок: срок
более: более
задавать: Задавая
наводящий: наводящие
вопрос: вопросы
землянин: землянин
наконец: наконец
добиться: добился
вразумительный: вразумительного
ответ: ответа
выражаться: выражаться
простой: просто
земной: земных
то: то
выходить: выходить
время: Время
ускорять: ускорять
орган: органы
чувство: чувств
вдвое: вдвое
бы: бы
замедляться: замедляется
тоже: тоже
весьма: Весьма
внушительный: внушительный
бонус: бонус
здорово: здорово
обучение: обучения
закончиться: закончился
капитан: капитан
вернуть: Врни
объявить: объявил
через: через
день: день
уже: уже
завтра: завтра
состояться: состоятся
соревнование: соревнования
пехотный: пехотному
взаимодействие: взаимодействию
идти: идти
зачет: зачет
дисциплина: дисциплине
финалист: финалисты
получить: получат
увольнительный: увольнительные
территория: территории
дело: дело
засесть: засел
изучение: изучение
правило: правил
зал: зале
где: где
курсант: курсант
принимать: принимали
присяга: присягу
менять: менять
пол: пол
цирк: цирках
арена: арену
вместо: Вместо
ровный: ровного
поверхность: поверхности
под: под
нога: ногами
оказываться: оказывался
обычный: обычные
грунт: грунт
ландшафт: Ландшафт
степной: степного
относительно: относительно
до: до
городской: городского
горный: горного
препятствие: Препятствия
постоянно: постоянно
моделироваться: моделировались
искин: ИскИн
поэтому: поэтому
практически: практически
повторяться: повторялись
условие: условием
попасть: попадут
испытуемый: испытуемые
даже: даже
высокий: высший
комсостав: комсостав
далекий: Дальше
один: одну
нужный: нужно
защищать: защищать
потому: потому
свой: своему
вражеский: вражеская
захватить: захватить
вариант: вариантов
уничтожить: уничтожить
группа: группа
экипировка: экипировка
учебный: учебного
предоставляться: предоставляется
вольный: вольна
выбирать: выбирают
усмотрение: усмотрению
ограничение: Ограничений
наставник: наставник
этотто: этомто
состоять: состоит
интрига: интрига
результат: результата
ждать: ждать
никто: никто
выбрать: выбрали
абсолютно: абсолютно
подходить: подходит
полигон: полигону
смоделировать: смоделировал
подвох: подвохом
принцип: принципе
важный: важно
тяжелый: тяжлые
легкий: легкие
точно: точно
щеголять: щеголяет
регулярный: регулярная
армия: армия
разве: разве
несколько: несколько
устареть: устаревшие
списать: списанные
свободный: свободную
продажа: продажу
да: да
программный: программное
обеспечение: обеспечение
бортовый: бортового
загрузить: загружена
программа: программа
полностью: полностью
деактивировать: деактивирует
после: после
попадание: попадание
естественно: Естественно
условно: условно
смертельный: смертельное
ежели: Ежели
посчитать: посчитает
ранение: ранением
продолжать: продолжать
сымитировать: сымитирует
повреждение: повреждение
какойлибо: какихлибо
буде: буде
соответствовать: соответствуют
ситуация: ситуации
продолжить: продолжит
воевать: воевать
ограниченный: ограниченными
штрих: штрих
заключаться: заключается
победа: победа
браться: бертся
захват: захватом
обязательный: обязательным
являться: является
присутствие: присутствие
команда: команды
хотя: хотя
выжить: выжившей
ее: е
часть: части
круг: круге
диаметр: диаметром
метр: метров
центр: центре
находиться: находится
кнопка: кнопка
нажать: нажать
внимание: вниманию
похожий: похожие
отобрать: отобрали
схожий: схожую
название: названию
смысл: смысле
литература: литературу
надежда: надежде
предоставить: предоставить
читатель: читателей
больше: больше
интересный: интересные
обсуждение: Обсуждение
собственный: собственные
оставить: Оставьте
думать: думаете
указать: Укажите
конкретно: конкретно
понравиться: понравилось
почему: почему
считать: считаете
