заголовок: Заголовок
олег: Олег
данильченко: Данильченко
имперский: Имперский
вояж: вояж
читать: читал
онлайн: онлайн
бесплатно: бесплатно
адрес: Адрес
здесь: Здесь
быть: быть
возможность: Возможность
весь: вс
текст: текст
электронный: электронной
книга: книге
совершенно: совершенно
целиком: целиком
полный: полны
версия: версию
в: в
некоторый: некоторых
случай: случаях
присутствовать: присутствует
краткий: краткое
содержание: содержание
город: Город
м: М
спб: СПб
год: лет
выпуск: выпуска
издательство: издательство
аста: АСТ
издательский: Издательский
дом: дом
ленинград: Ленинград
категория: категорию
боевой: Боевая
фантастика: фантастика
космический: Космическая
на: на
русский: русском
язык: языке
описание: описание
произведение: произведении
предисловие: предисловие
а: а
так: так
же: же
отзыв: отзывы
посетитель: посетителей
доступный: доступны
портал: портале
библиотека: Библиотека
либ: Либ
кат: Кат
создать: создана
для: для
любитель: любителей
полистать: полистать
хороший: хорош
книжка: книжку
и: и
предлагать: Предлагаем
широкий: широкий
выбор: выбора
жанр: жанров
любовный: любовные
роман: романы
фэнтези: фэнтези
приключение: приключения
детектив: детективы
триллер: триллеры
эротика: эротика
документальный: документальные
научный: научные
юмористический: юмористические
анекдот: анекдоты
о: о
бизнес: бизнесе
проза: проза
детский: детские
сказка: сказки
религиия: религиии
новинка: новинки
православный: православные
старинный: старинные
про: про
компьютер: компьютеры
программирование: программирование
английский: английском
домоводство: домоводство
поэзия: поэзия
выбрав: Выбрав
по: по
душа: душе
вы: Вы
смочь: сможете
найти: нашли
действительно: действительно
стоить: стоящие
насладиться: насладиться
погружение: погружением
мир: мир
воображение: воображения
прочувствовать: прочувствовать
переживание: переживания
герой: героях
или: или
узнать: Узнайте
себя: собой
чтото: чтото
новый: новые
совершить: совершить
внутренний: внутренние
открытие: открытие
подробный: Подробная
информация: информацию
ознакомление: ознакомления
текущий: текущему
запрос: запросу
представить: представлен
низкий: Ниже
к: к
чтение: чтение
аннотация: аннотацию
зависеть: зависит
от: от
тот: то
что: что
написать: напишите
сам: сам
автор: автора
если: Если
не: не
необходимый: необходимо
комментарий: комментарии
мы: Мы
постараться: постараемся
отыскать: отыскать
она: она
кто: кто
фамилия: фамилию
как: как
звать: зовут
список: списком
его: его
серия: серия
уважаемые: Уважаемые
правообладатель: правообладатели
размещать: размещать
наш: нашем
сайт: сайте
у: у
любой: любой
зарегистрировать: зарегистрированного
пользователь: пользователя
ваш: ваши
опубликовать: опубликована
без: без
согласие: согласия
пожалуйста: пожалуйста
направить: направьте
жалоба: жалобу
заполните: заполните
форма: форму
обратный: обратной
связь: связи
течение: течение
час: часов
закрыть: закроем
доступ: доступ
нелегально: нелегально
разместить: размещенному
контент: контенту
разбить: разбитый
страница: страницу
система: Система
сохранение: сохранения
место: местах
последний: последней
прочитать: прочитанные
позволять: позволяет
с: с
удобство: удобством
необходимость: необходимости
каждый: каждый
раз: разу
заново: заново
искать: искать
остановиться: остановились
поставить: Поставьте
закладка: Закладка
момент: момент
перейти: перейти
который: который
закончить: закончили
шрифт: Шрифт
интервал: Интервал
бы: бы
ты: ты
классика: классику
изучать: изучала
б: б
свой: своего
время: время
положенный: положенную
то: то
я: я
превеликий: превеликим
удовольствие: удовольствием
цыц: Цыц
устройство: устройство
неуч: неуча
слышать: слышу
сказать: сказать
курсант: курсанта
прозвучать: Прозвучавший
вопрос: вопрос
вывести: вывел
илюха: Илюха
из: из
раздумье: раздумий
считать: считаете
выполнить: выполнил
комплекс: Комплекс
ошибка: ошибок
ответить: ответив
землянин: Землянин
мочь: может
уважаемый: уважаемый
инструктор: инструктор
отвлечься: отвлекся
немного: немного
поэтому: Поэтому
подумать: подумал
упустить: упустил
такой: такой
тоже: тоже
случаться: случается
согласиться: согласился
вернуть: Врни
тогда: Тогда
более: более
должный: должно
понять: понял
установить: установить
истина: истину
правило: Правила
допускать: допускают
проведение: проведение
тестовый: тестового
поединок: поединка
выяснение: выяснения
правый: правая
конечный: конечном
итог: итоге
готовый: готов
это: Этого
да: Да
мешкать: мешкать
господин: Господин
просить: прошу
выход: выход
глянуть: глянул
высокий: высокого
мужчина: мужчины
фигура: фигурой
гимнаст: гимнаста
вид: вид
привычный: привычные
тридцать: тридцать
можно: можно
дать: дать
успех: успехом
он: он
сто: сто
двести: двести
даже: даже
триста: триста
половина: половиной
легкий: легкий
учитывать: учитывать
возможно: возможно
солидный: солидный
возраст: возраст
соответствовать: соответствующий
опыт: опыт
дело: деле
неумех: неумеху
вряд: вряд
ли: ли
пригласить: пригласили
тут: тут
надо: надо
оооочень: оооочень
осторожный: осторожным
илья: Илья
встать: встал
обманчивый: обманчиво
расслабить: расслабленную
стойка: стойку
зевран: Зевран
вдалбливать: вдалбливал
наверное: наверное
больше: больше
чем: чем
остальной: Остальные
утверждать: утверждая
самый: самое
главный: главных
прием: примы
просто: просто
подправлять: подправлял
добиваться: добиваясь
нужный: Нужно
результат: результате
эффект: эффекта
убирать: Убирая
оттуда: оттуда
лишний: лишнее
выйти: вышло
арена: арену
дядечка: дядечка
поклониться: поклонился
трибуна: трибуне
обозначить: обозначил
поклон: поклон
остаться: остаться
долг: долгу
спускать: спуская
при: при
глаз: глаза
противник: противник
показной: показной
вялость: вялостью
ухмыльнуться: ухмыльнулся
вдруг: вдруг
внезапно: внезапно
атаковать: атаковал
зритель: зрителей
случиться: случиться
неожиданно: неожиданно
только: только
ждать: ждал
плавный: Плавный
уход: уход
изпод: изпод
удар: удар
разрыв: разрыв
дистанция: дистанцию
совсем: совсем
собираться: собирался
равный: равных
бороться: бороться
профессионал: профессионалом
продержаться: продержаться
минута: минуту
нога: ног
мужик: Мужик
удивленный: удивлнно
поднять: поднял
бровь: бровь
ожидать: ожидал
мальчишка: мальчишки
вновь: вновь
замереть: замерли
снова: снова
быстрый: быстр
атака: атака
опять: опять
уходить: уходит
разрывать: разрывая
затем: Затем
последовать: последовала
сразу: сразу
молниеносный: молниеносных
тычок: тычков
повторить: повторили
судьба: судьбу
два: двух
предыдущий: предыдущих
благополучно: благополучно
убить: убив
воздух: воздух
истечь: истекло
бой: бой
остановить: остановить
красный: красный
вареный: вареный
рак: рак
огонь: огонь
ноздря: ноздрей
извергать: извергал
ни: ни
коснуться: коснулся
этот: этого
сопляк: сопляка
злой: зол
значить: значит
вообще: вообще
ничто: ничего
но: Но
проигнорировать: проигнорировали
истекший: исткшее
подойти: подошел
признавать: признавая
поражение: поражение
расслабиться: расслабился
изобразить: изобразил
получить: получив
практически: практически
одновременный: одновременных
ребро: рбра
бросить: бросило
назад: назад
пронзить: пронзив
резкий: резкой
боль: болью
внимание: вниманию
бить: бьет
уничтожение: уничтожение
затараторить: затараторила
ди: Ди
сломать: сломана
сторона: стороны
отключаю: Отключаю
болевой: болевого
центр: центры
босс: босс
беречь: Береги
корпус: корпус
довольный: Довольный
воздеть: воздел
над: над
голова: головой
рука: рука
забыть: забыв
экзаменовать: экзаменует
молодой: молодого
находиться: находится
профессиональный: профессиональном
ринг: ринге
увидеть: увидеть
уничтожить: уничтожить
вставать: встат
за: за
спина: спиной
обязанный: обязаны
проткнуть: проткнуть
орган: органы
сердце: сердце
число: числе
удивление: удивления
когда: когда
повернуться: повернувшись
голос: голос
узреть: узрел
перед: перед
бледный: бледное
вполне: вполне
живой: живого
парень: парень
дядя: дядя
думать: думаете
ошибаться: Ошибаешься
улыбнуться: Улыбнулся
наглец: наглец
взревев: Взревев
ускорить: ускорил
восприятие: восприятие
посыпаться: посыпались
один: один
другой: другим
они: они
ненавистный: ненавистного
малец: мальца
вот: Вот
достигнуть: достигнуть
цель: цели
маленький: Мало
ответ: ответ
полететь: полетели
плюха: плюхи
организм: организм
модифицировать: модифицирован
имплантат: имплантата
ми: ми
давно: давно
прийтись: пришлось
уже: уже
валяться: валяться
пол: полу
до: до
невозможность: невозможности
никак: никак
прилетать: прилетало
три: три
великий: Великая
бездна: бездна
двигаться: двигаться
какойто: какойто
работать: работает
выдернуть: выдернутая
суставный: суставной
сумка: сумки
второй: вторая
усилие: Усилием
воля: воли
загнать: загнал
вылезти: вылезшее
наружу: наружу
чувство: чувство
страх: страха
давненько: Давненько
испытывать: испытывал
пацан: пацан
продолжать: продолжал
кружить: кружить
пребольно: пребольно
жаля: жаля
лицо: лицо
покрыть: покрытое
мелкий: мелкими
бисеринка: бисеринками
пот: пота
похожий: похожие
застывший: застывшую
маска: маску
полыхать: полыхали
ледяной: ледяной
ярость: яростью
опытный: Опытный
боец: боец
смерть: смерть
ну: Ну
какой: какого
ляд: ляда
повестись: повелся
посул: посулы
капитан: капитана
сумма: сумма
приличный: приличная
теперь: Теперь
пригодиться: пригодится
ведь: ведь
тревожный: тревожный
звоночек: звоночек
показать: показал
очень: Очень
разглядеть: разглядел
нем: нм
знакомый: знакомое
когдато: Когдато
начать: начал
постигать: постигать
аз: азы
рукопашный: рукопашного
собственный: собственные
привести: привел
ученик: ученикам
бывший: бывшего
спец: спеца
гвардия: гвардии
император: императора
вместе: вместе
служить: служили
устроить: устроил
показательный: показательный
там: там
сейчас: сейчас
довестись: довелось
откуда: откуда
успеть: успел
додумать: додумать
между: между
сила: силы
сознание: сознание
отключиться: отключилось
спасать: спасая
хозяин: хозяина
шок: шока
представлять: Представляем
отобрать: отобрали
схожий: схожую
название: названию
смысл: смысле
литература: литературу
надежда: надежде
предоставить: предоставить
читатель: читателей
вариант: вариантов
интересный: интересные
еще: ещ
обсуждение: Обсуждение
мнение: мнения
оставить: Оставьте
указать: Укажите
конкретно: конкретно
понравиться: понравилось
нет: нет
почему: почему
