заголовок: Заголовок
олег: Олег
данильченко: Данильченко
имперский: Имперский
вояж: вояж
читать: читал
онлайн: онлайн
бесплатно: бесплатно
адрес: Адрес
здесь: Здесь
быть: было
возможность: возможность
весь: всего
текст: текст
электронный: электронной
книга: книге
совершенно: совершенно
целиком: целиком
полный: полную
версия: версию
в: в
некоторый: некоторых
случай: случаях
присутствовать: присутствует
краткий: краткое
содержание: содержание
город: Город
м: М
спб: СПб
год: год
выпуск: выпуска
издательство: издательство
аста: АСТ
издательский: Издательский
дом: дом
ленинград: Ленинград
категория: категорию
боевой: боевым
фантастика: фантастика
космический: Космическая
на: на
русский: русском
язык: языке
описание: описание
произведение: произведении
предисловие: предисловие
а: а
так: так
же: же
отзыв: отзывы
посетитель: посетителей
доступный: доступны
портал: портале
библиотека: Библиотека
либ: Либ
кат: Кат
создать: создана
для: для
любитель: любителей
полистать: полистать
хороший: лучших
книжка: книжку
и: и
предлагать: Предлагаем
широкий: широкий
выбор: выбора
жанр: жанров
любовный: любовные
роман: романы
фэнтези: фэнтези
приключение: приключения
детектив: детективы
триллер: триллеры
эротика: эротика
документальный: документальные
научный: научные
юмористический: юмористические
анекдот: анекдоты
о: о
бизнес: бизнесе
проза: проза
детский: детские
сказка: сказки
религиия: религиии
новинка: новинки
православный: православные
старинный: старинные
про: про
компьютер: компьютеры
программирование: программирование
английский: английском
домоводство: домоводство
поэзия: поэзия
выбрав: Выбрав
по: по
душа: душе
вы: Вы
смочь: смог
найти: найти
действительно: действительно
стоить: стоит
насладиться: насладиться
погружение: погружением
мир: мир
воображение: воображения
прочувствовать: прочувствовать
переживание: переживания
герой: героях
или: или
узнать: Узнайте
себя: собой
чтото: чтото
новый: новые
совершить: совершить
внутренний: внутреннее
открытие: открытие
подробный: Подробная
информация: информацию
ознакомление: ознакомления
текущий: текущему
запрос: запросу
представить: представлен
низкий: ниже
к: к
чтение: чтение
аннотация: аннотацию
зависеть: зависит
от: от
тот: то
что: что
написать: напишите
сам: сам
автор: автора
если: если
не: не
необходимый: необходимую
комментарий: комментарии
мы: Мы
постараться: постараемся
отыскать: отыскать
она: е
кто: Кто
фамилия: фамилию
как: как
звать: звать
список: списком
его: его
серия: сериям
уважаемые: Уважаемые
правообладатель: правообладатели
размещать: размещать
наш: нашей
сайт: сайте
у: у
любой: любыми
зарегистрировать: зарегистрированного
пользователь: пользователя
ваш: ваши
опубликовать: опубликована
без: без
согласие: согласия
пожалуйста: пожалуйста
направить: направьте
жалоба: жалобу
заполните: заполните
форма: форму
обратный: обратной
связь: связи
течение: течение
час: часов
закрыть: закроем
доступ: доступ
нелегально: нелегально
разместить: размещенному
контент: контенту
разбить: разбитый
страница: страницу
система: Система
сохранение: сохранения
место: месте
последний: последнее
прочитать: прочитанные
позволять: позволяет
с: с
удобство: удобством
необходимость: необходимости
каждый: каждый
раз: раза
заново: заново
искать: искать
остановиться: остановились
поставить: Поставьте
закладка: Закладка
момент: момент
перейти: перейти
который: который
закончить: закончившим
шрифт: Шрифт
интервал: Интервал
да: Да
я: я
должный: должен
он: его
помогать: помогать
сопляк: сопляком
ты: ты
когдато: когдато
помочь: помог
но: но
потому: потому
это: Это
попросить: попросил
просто: просто
человек: человеком
правильный: ПРАВИЛЬНО
почему: почему
решить: решил
устать: устало
спросить: спросил
бал: Балах
чутье: Чутье
почувствовать: почувствовал
тогда: тогда
трус: трус
оказаться: оказался
правый: прав
ведь: Ведь
никто: никто
просить: просил
за: за
вступаться: вступаться
вот: вот
понять: поняли
бы: бы
урод: уродом
думать: думаете
только: только
этот: эти
еще: ещ
свой: своего
команда: команду
тащить: тащит
ну: ну
б: б
непроходимый: непроходимо
тупой: туп
то: то
парень: парень
твой: твоих
шанс: шанс
выбраться: выбраться
наконец: наконец
из: из
дерьмо: дерьмо
загнать: загнал
вернуть: Врни
поверь: Поверь
мальчик: мальчик
маменькин: маменькиных
сынок: сынков
дорогой: дорогими
сетка: сетками
нагнет: нагнт
мало: мало
показаться: покажется
немного: немного
поделиться: поделись
знать: знает
слушать: Слушай
зевран: Зеврану
вообще: вообще
переживаешь: переживаешь
допустить: Допустим
мозг: мозги
ли: ли
такой: такое
пройти: прошло
через: через
школа: школы
пусть: пусть
трижды: трижды
тыто: тебето
много: много
говорить: говоря
ладный: Ладно
мочь: могло
ребята: ребята
однако: Однако
ни: ни
один: одну
похожий: похожие
одержимый: одержим
знание: знаний
причем: причм
до: до
дотянуться: дотянуться
дело: делам
дикий: дикий
отдать: отдал
чтобы: чтобы
дикарь: дикарей
империя: Империи
больше: больше
жиреем: Жиреем
понимать: понимаешь
мозги: Мозги
размягчаться: размягчаются
посмотреть: посмотри
уже: уже
несколько: несколько
тысяча: тысяч
цикл: циклов
техника: Техника
все: вс
ничто: ничего
прогресс: Прогресса
практически: практически
нет: нет
считать: считаете
улучшение: улучшений
старый: старом
большой: большой
счет: счту
изжить: изжили
нужный: нужна
свежий: свежая
кровь: Кровь
зашоренных: зашоренных
условность: условностях
даже: даже
принятый: принято
учиться: учиться
постоянно: постоянно
под: под
разгон: разгоном
хотя: хотя
соглашаться: соглашаешься
возможный: возможно
принять: принято
значить: значит
запретить: запрещено
верно: верно
делать: делал
более: более
эффективно: эффективно
при: при
забывать: забывает
главный: главных
дать: дай
хотеть: хочет
выгодный: выгодно
сделать: сделаю
ставка: ставку
гарантировать: гарантирую
прогадать: прогадаешь
забыть: забыли
получить: получишь
благодарный: благодарного
придача: придачу
когданибудь: когданибудь
пригодиться: пригодилось
напоминать: напоминает
внук: Внуку
шустрый: шустрый
рядом: рядом
когда: когда
ичелера: ИчеЛер
подразделение: подразделения
вырезать: вырезали
командование: командования
посчитать: посчитало
они: них
запланировать: запланированные
потеря: потери
оставить: Оставьте
помощь: помощи
сей: сих
пора: пор
винить: виню
ято: ято
пожить: пожил
мальчишка: мальчишкой
хоть: хоть
легче: легче
стать: стало
теперь: Теперь
понятный: понятно
отцовский: отцовский
инстинкт: инстинкт
проснуться: проснулся
честно: Честно
взяться: взяться
мой: моих
ребятишки: ребятишек
серьезно: серьезно
готовый: готов
согласиться: согласиться
просьба: просьбой
нравоучение: нравоучений
сколько: Сколько
обижаться: обижайся
черим: Черим
ж: ж
любя: любя
друг: друга
сейчас: сейчас
пойти: пойдм
напеть: напою
гез: гезом
сюда: сюда
прийти: пришел
разговор: разговор
состояться: состоялся
илюхато: Илюхато
слышать: слышать
поэтому: поэтому
сюрприз: сюрпризом
следующий: следующий
день: день
проблема: проблема
разгонный: разгонными
картридж: картриджами
разрешиться: разрешилась
закончиться: закончились
удивительно: Удивительно
видеть: видели
спокойный: спокойно
скорый: скорее
флегматичный: флегматичный
развить: развил
бурный: бурную
деятельность: деятельность
вносить: внося
незначительный: незначительные
изменение: изменения
процесс: процесс
обучение: обучения
подсказывать: подсказывая
намекать: намекая
эффективный: эффективные
решение: решения
особенно: Особенно
заметный: заметно
второй: второй
неделя: неделе
виртуальный: виртуальные
тренировка: тренировки
пилотирование: пилотированию
фрегат: фрегатов
раньшето: Раньшето
наставник: наставники
два: два
утро: Утром
открывать: открывал
помещение: помещение
тренажерный: тренажерными
капсула: капсулами
вечер: вечером
закрывать: закрывал
находиться: находился
подопечный: подопечными
внимательно: внимательно
наблюдать: наблюдая
их: их
действие: действиями
также: также
зорко: зорко
следить: следя
применение: применением
химия: химии
давать: давать
перегружать: перегружать
дед: дед
зев: Зева
тоже: тоже
простой: простым
оружейник: оружейником
выясниться: Выяснилось
прошлое: прошлом
командир: командиры
специальный: специального
разведывательнодиверсионный: разведывательнодиверсионного
впоследствии: впоследствии
самый: самым
инструктор: инструктором
императорский: императорской
военный: военную
академия: академию
готовить: готовили
личный: личные
гвардия: гвардии
император: императоре
тут: тут
появляться: появляется
закономерный: закономерный
вопрос: вопрос
зубр: зубр
какойто: какойто
занюхать: занюханная
вопервых: вопервых
вовторых: Вовторых
возраст: возраст
втретьих: втретьих
ктото: ктото
высокий: высших
круг: кругах
подготовка: подготовка
абсолютно: абсолютно
учет: учетом
бронь: брони
мощный: мощная
вооружение: вооружения
навык: навыки
мастерство: мастерстве
искусство: искусств
перебор: перебор
общий: общем
понизить: понизили
планка: планку
остаться: остался
работа: работы
конечно: конечно
почет: почтом
выпнуль: выпнули
пенсия: пенсию
повесить: повесили
медалька: медальку
очень: очень
неплохой: неплохая
сидеть: сидеть
привыкнуть: привык
попроситься: попросился
бывший: бывшему
сослуживец: сослуживцу
свести: свела
судьба: судьба
сопливый: сопливым
нынешний: нынешнем
заслужить: заслуженным
офицер: офицером
время: время
отправляться: отправлялся
куданибудь: куданибудь
государство: государства
приходиться: приходилось
таскать: таскать
эскорт: эскорт
обеспечение: обеспечения
безопасность: безопасности
монарх: Монарх
уважать: уважаем
армия: армии
народ: народе
именно: именно
причина: причине
нелюбимый: нелюбим
злопыхатель: злопыхателями
бардак: бардак
ловить: ловить
рыбка: рыбку
мутный: мутной
водица: водице
покушение: покушений
жизнь: жизнь
можно: можно
сбиться: сбиться
многий: многие
предотвратить: предотвращены
благодаря: благодаря
тогдато: Тогдато
молодой: молодых
перспективный: перспективных
пилот: пилотов
незаслуженно: незаслуженно
обвинить: обвинили
трусость: трусости
надо: надо
награждать: награждать
геройство: геройство
расстреливать: расстреливать
махровый: махровую
глупость: глупость
знакомство: знакомство
организовываться: организовывалась
недавно: недавно
выйти: вышедший
энтузиазм: энтузиазмом
заниматься: занимался
создание: созданием
нуль: нуля
начать: начала
результат: результаты
вид: виде
деньга: денег
устареть: устаревшие
база: базы
специалист: специалистов
найтись: нашлись
желать: желающие
возглавить: возглавить
волшебный: волшебным
образ: образом
трудяга: трудяга
сместить: смещн
должность: должности
начальник: начальника
сначала: Сначала
заместитель: заместители
потом: потом
отделение: отделения
затем: затем
глубокий: глубже
макнуть: макнуть
падать: падать
некуда: некуда
наказание: наказанием
пытаться: пытался
правда: правду
справедливость: справедливость
вряд: вряд
произойти: произойти
самозабвенно: самозабвенно
плясать: плясал
дудка: дудку
элентийский: Элентийского
союз: союза
запросто: запросто
короче: короче
дедка: дедок
непростой: непростым
двое: двое
вдруг: вдруг
приняться: принялись
илюха: Илюху
всерьез: всерьз
представлять: Представляем
внимание: вниманию
отобрать: отобрали
схожий: схожую
название: названию
смысл: смысле
литература: литературу
надежда: надежде
предоставить: предоставить
читатель: читателей
вариант: вариантов
интересный: интересные
обсуждение: Обсуждение
собственный: собственные
мнение: мнения
указать: Укажите
конкретно: конкретно
понравиться: понравилось
