заголовок: Заголовок
олег: Олег
данильченко: Данильченко
имперский: Имперский
вояж: вояж
читать: читать
онлайн: онлайн
бесплатно: бесплатно
адрес: Адрес
здесь: Здесь
быть: был
возможность: возможность
весь: вс
текст: текст
электронный: электронной
книга: книге
совершенно: совершенно
целиком: целиком
полный: полную
версия: версию
в: в
некоторый: некоторыми
случай: случаях
присутствовать: присутствует
краткий: краткое
содержание: содержание
город: Город
м: М
спб: СПб
год: год
выпуск: выпуска
издательство: издательство
аста: АСТ
издательский: Издательский
дом: дом
ленинград: Ленинград
категория: категорию
боевой: Боевая
фантастика: фантастика
космический: Космическая
на: на
русский: русском
язык: языке
описание: описание
произведение: произведении
предисловие: предисловие
а: а
так: так
же: же
отзыв: отзывы
посетитель: посетителей
доступный: доступны
портал: портале
библиотека: Библиотека
либ: Либ
кат: Кат
создать: создана
для: для
любитель: любителей
полистать: полистать
хороший: хорошую
книжка: книжку
и: и
предлагать: Предлагаем
широкий: широкий
выбор: выбора
жанр: жанров
любовный: любовные
роман: романы
фэнтези: фэнтези
приключение: приключения
детектив: детективы
триллер: триллеры
эротика: эротика
документальный: документальные
научный: научные
юмористический: юмористические
анекдот: анекдоты
о: о
бизнес: бизнесе
проза: проза
детский: детские
сказка: сказки
религиия: религиии
новинка: новинки
православный: православные
старинный: старинные
про: про
компьютер: компьютеры
программирование: программирование
английский: английском
домоводство: домоводство
поэзия: поэзия
выбрав: Выбрав
по: по
душа: душе
вы: Вы
смочь: сможете
найти: нашли
действительно: действительно
стоить: стоящие
насладиться: насладиться
погружение: погружением
мир: мира
воображение: воображения
прочувствовать: прочувствовать
переживание: переживания
герой: героях
или: или
узнать: Узнайте
себя: собой
чтото: чтото
новый: новые
совершить: совершить
внутренний: внутреннее
открытие: открытие
подробный: Подробная
информация: информацию
ознакомление: ознакомления
текущий: текущему
запрос: запросу
представить: представлен
низкий: Ниже
к: к
чтение: чтение
аннотация: аннотацию
зависеть: зависит
от: от
тот: том
что: что
написать: напишите
сам: самом
автор: автора
если: Если
не: не
необходимый: необходимую
комментарий: комментарии
мы: Мы
постараться: постараемся
отыскать: отыскать
она: нее
кто: Кто
фамилия: фамилию
как: Как
звать: зовут
список: списком
его: его
серия: сериям
уважаемые: Уважаемые
правообладатель: правообладатели
размещать: размещать
наш: Наши
сайт: сайте
у: у
любой: любой
зарегистрировать: зарегистрированного
пользователь: пользователя
ваш: ваши
опубликовать: опубликована
без: без
согласие: согласия
пожалуйста: пожалуйста
направить: направьте
жалоба: жалобу
заполните: заполните
форма: формы
обратный: обратной
связь: связи
течение: течение
час: часов
закрыть: закроем
доступ: доступ
нелегально: нелегально
разместить: размещенному
контент: контенту
разбить: разбитый
страница: страницу
система: Система
сохранение: сохранения
место: места
последний: последней
прочитать: прочитанные
позволять: позволяет
с: С
удобство: удобством
необходимость: необходимости
каждый: каждого
раз: раз
заново: заново
искать: ищете
остановиться: остановились
поставить: Поставьте
закладка: Закладка
момент: момент
перейти: перейти
который: которое
закончить: закончили
шрифт: Шрифт
интервал: Интервал
удивиться: удивился
он: он
свой: своему
одежда: одежда
естественно: Естественно
док: док
засмеяться: засмеялся
дело: дело
молодой: молодой
человек: человек
когда: когда
обнаружить: обнаружили
никакой: никакой
это: это
значить: значит
я: я
дорога: дороге
голый: голым
ну: Ну
какойто: какойто
степень: степени
именно: именно
тоже: тоже
поговорить: поговорим
поздний: позже
пока: пока
вот: вот
взять: взял
стол: столу
блестящий: блестящий
запаять: запаянный
прямоугольный: прямоугольный
пакет: пакет
хитрый: Хитрым
образ: образом
сделать: сделать
раскрыться: раскрылся
внутри: Внутри
лежать: лежал
комбинезон: комбинезонах
абсолютно: абсолютно
бесформенный: бесформенный
минимум: минимум
шесть: шесть
размер: размер
больше: больше
чем: чем
требоваться: требуется
илья: Илья
носить: носил
удивленно: удивленно
спросить: спросил
наконецто: наконецто
удаться: удалось
удивить: удивить
радостно: Радостно
осклабиться: осклабился
мочь: можете
беспокоиться: беспокоиться
подстроиться: подстроился
под: под
ведь: ведь
просто: просто
повседневный: Повседневный
использование: использования
военный: военного
флот: флоте
нужный: нужен
только: Только
прикрытие: прикрытия
нагота: наготы
но: но
помочь: поможет
аварийный: аварийной
ситуация: ситуации
еще: ещ
узнавать: узнаете
произносить: произносил
этот: эта
речь: речь
влезть: влез
технический: технической
мысль: мысли
костюм: костюма
быстро: быстро
плотно: плотно
обжать: обжал
тело: тело
кроме: Кроме
откудато: откудато
из: из
воротник: воротника
выскочить: выскочил
капюшон: капюшон
также: также
охватить: охватил
голова: голову
лицо: лицо
число: числе
после: После
спрятаться: спрятался
обратно: обратно
илюха: Илюха
ошарашенно: ошарашенно
смотреть: смотрите
довольный: довольную
физиономия: физиономию
собеседник: собеседника
светиться: светилась
удовольствие: удовольствия
прекратить: Прекратите
надо: надо
издеваться: издеваться
возмутиться: возмутился
извинить: Извините
такой: таких
невозмутимый: невозмутимый
удержаться: удержаться
маленький: маленькой
безобидный: безобидной
шутка: шутки
сказать: сказав
заранее: заранее
какой: какой
произойти: произойдт
подгонка: подгонка
уже: уже
говорить: говорил
кизп: КИЗП
тут: тут
поднять: поднял
палец: палец
вверх: вверх
индивидуальный: Индивидуальной
защита: защиту
десятый: десятого
поколение: поколения
образец: образец
случиться: случится
разгерметизация: разгерметизация
отсек: отсека
находиться: находится
то: то
производство: производства
обеспечить: обеспечит
двадцать: двадцати
минута: минут
дать: даст
добраться: добраться
до: до
полноценный: полноценного
скафандр: скафандра
условие: условиях
абсолютный: абсолютного
вакуум: вакуума
отрицательный: отрицательных
температура: температурах
хм: Хм
серьезный: серьезная
оценить: оценил
характеристика: характеристики
считать: считаете
второй: вторая
кожа: кожа
очень: очень
нравиться: нравится
понимать: Понимаете
ключ: ключе
мой: моего
любить: любят
одеваться: одеваются
женщина: женщины
чтобы: чтобы
подчеркнуть: подчеркнуть
показать: показать
достоинство: достоинства
фигура: фигуру
разумеется: Разумеется
показывать: показывать
мужчина: мужчины
за: За
редкий: редким
нетрадиционный: нетрадиционным
исключение: исключением
можно: можно
чтолибо: чтолибо
правый: правы
похожий: похожие
грешить: грешат
подобный: подобным
поведение: поведением
проблема: проблему
решить: решить
манжета: манжете
левый: левого
рукав: рукава
три: три
точка: точки
нажать: нажать
один: одну
удерживать: удерживать
ослабить: ослабит
охват: охват
ослаблять: ослаблять
почувствовать: почувствуете
комфортно: комфортно
убрать: уберте
наоборот: наоборот
обжатие: обжатие
плотный: плотнее
третий: Третья
зафиксировать: зафиксирует
выбрать: выбранные
параметр: параметры
навсегда: навсегда
изначальный: изначальное
запомнить: запомнить
цель: цели
активироваться: активировался
большой: большое
потревожить: потревожит
сработать: сработает
при: при
подогнать: подогнал
комбез: комбеза
вкус: вкусу
довольно: довольно
осмотреть: осмотрел
обувь: обуви
оказаться: оказалась
столь: столь
технологичный: технологичной
удобный: удобной
обхватить: обхватив
голеностоп: голеностоп
мягко: мягко
жизнь: жизнь
ощущение: Ощущения
разнашивать: разнашивать
готовый: готовую
идти: идти
проголодаться: проголодался
да: Да
спасибо: спасибо
глава: Глава
столовая: Столовая
представлять: Представляем
помещение: помещение
располагаться: располагались
пять: пятью
ровный: ровными
ряд: рядами
десять: десять
овальный: овальной
кресло: кресло
вокруг: вокруг
они: них
сидеть: сидели
надеть: надет
другой: других
расцветка: расцветок
встречаться: Встречались
черный: чрные
оранжевый: оранжевые
темносиний: тмносиние
зеленый: зелные
белый: белые
цвет: цвета
подойти: подошел
близкий: ближайшему
свободный: свободному
присаживайтесь: Присаживайтесь
сесть: сел
крайний: крайнее
доктор: доктор
устроиться: устроился
напротив: напротив
продолжать: продолжая
поучительный: поучительную
лекция: лекцию
перед: Перед
панель: панель
заказ: заказ
набрать: набрать
название: названию
блюдо: блюда
хотеть: хотите
пищевой: пищевой
синтезатор: синтезатор
выполнить: выполнит
открыться: Откроется
забрать: забрать
пища: пищу
конечно: конечно
познавательный: познавательно
крайне: крайне
интересный: интересные
знать: знаю
местный: местной
кухня: кухне
чудопечка: чудопечка
вряд: вряд
ли: ли
разбираться: разбирается
находить: находите
внимание: вниманию
отобрать: отобрали
схожий: схожую
смысл: смысле
литература: литературу
надежда: надежде
предоставить: предоставить
читатель: читателей
вариант: вариантов
обсуждение: Обсуждение
собственный: собственные
мнение: мнения
оставить: Оставьте
думать: думаете
главный: главных
указать: Укажите
конкретно: конкретно
понравиться: понравилось
нет: нет
почему: почему
