заголовок: Заголовок
олег: Олег
данильченко: Данильченко
имперский: Имперский
вояж: вояж
читать: читать
онлайн: онлайн
бесплатно: бесплатно
адрес: Адрес
здесь: Здесь
быть: были
возможность: Возможность
весь: всм
текст: текст
электронный: электронной
книга: книге
совершенно: совершенно
целиком: целиком
полный: полнейший
версия: версию
в: в
некоторый: некоторых
случай: случаях
присутствовать: присутствует
краткий: краткое
содержание: содержание
город: Город
м: М
спб: СПб
год: год
выпуск: выпуска
издательство: издательство
аста: АСТ
издательский: Издательский
дом: дом
ленинград: Ленинград
категория: категорию
боевой: Боевая
фантастика: фантастика
космический: Космическая
на: на
русский: русском
язык: язык
описание: описание
произведение: произведении
предисловие: предисловие
а: а
так: так
же: же
отзыв: отзывы
посетитель: посетителей
доступный: доступна
портал: портале
библиотека: Библиотека
либ: Либ
кат: Кат
создать: создана
для: для
любитель: любителей
полистать: полистать
хороший: хорошую
книжка: книжку
и: и
предлагать: Предлагаем
широкий: широкий
выбор: выбора
жанр: жанров
любовный: любовные
роман: романы
фэнтези: фэнтези
приключение: приключения
детектив: детективы
триллер: триллеры
эротика: эротика
документальный: документальные
научный: научные
юмористический: юмористические
анекдот: анекдоты
о: о
бизнес: бизнесе
проза: проза
детский: детские
сказка: сказки
религиия: религиии
новинка: новинки
православный: православные
старинный: старинные
про: про
компьютер: компьютер
программирование: программирование
английский: английском
домоводство: домоводство
поэзия: поэзия
выбрав: Выбрав
по: по
душа: душе
вы: Вы
смочь: сможете
найти: нашли
действительно: действительно
стоить: стоящие
насладиться: насладиться
погружение: погружением
мир: мире
воображение: воображения
прочувствовать: прочувствовать
переживание: переживания
герой: героях
или: или
узнать: Узнайте
себя: себя
чтото: чтото
новый: новые
совершить: совершить
внутренний: внутренние
открытие: открытие
подробный: Подробная
информация: информации
ознакомление: ознакомления
текущий: текущему
запрос: запросу
представить: представлен
низкий: Ниже
к: к
чтение: чтение
аннотация: аннотацию
зависеть: зависело
от: от
тот: То
что: что
написать: напишите
сам: самого
автор: автора
если: если
не: не
необходимый: необходимую
комментарий: комментарии
мы: Мы
постараться: постараемся
отыскать: отыскать
она: е
кто: Кто
фамилия: фамилию
как: как
звать: зовут
список: списком
его: его
серия: сериям
уважаемые: Уважаемые
правообладатель: правообладатели
размещать: размещать
наш: нашем
сайт: сайте
у: у
любой: любой
зарегистрировать: зарегистрированного
пользователь: пользователя
ваш: ваши
опубликовать: опубликована
без: без
согласие: согласия
пожалуйста: пожалуйста
направить: направьте
жалоба: жалобу
заполните: заполните
форма: форму
обратный: обратной
связь: связи
течение: течение
час: часов
закрыть: закроем
доступ: доступ
нелегально: нелегально
разместить: размещенному
контент: контенту
разбить: разбитый
страница: страницу
система: Система
сохранение: сохранения
место: место
последний: последней
прочитать: прочитанные
позволять: позволяет
с: с
удобство: удобством
необходимость: необходимости
каждый: каждый
раз: раз
заново: заново
искать: искать
остановиться: остановились
поставить: Поставьте
закладка: Закладка
момент: момент
перейти: перейти
который: который
закончить: закончили
шрифт: Шрифт
интервал: Интервал
это: это
ясный: ясно
вот: вот
нейросеть: нейросеть
прочий: прочего
имплантат: имплантаты
кстати: кстати
тоже: тоже
выйти: вышедшими
из: из
адский: адских
лаборатория: лабораторий
элента: эленте
почему: почему
илья: Ильи
получаться: получалось
бы: бы
биокомпьютерсимбионт: биокомпьютерсимбионт
устанавливаться: устанавливались
прямо: прямо
дыня: дыню
смысл: смысле
мозг: мозге
после: после
активация: активации
начинать: Начиная
исполнять: исполнять
функция: функцию
персональный: персонального
коммуникатор: коммуникатора
мобильник: мобильник
паспорт: паспорт
да: Да
много: много
еще: ещ
разный: разные
кроме: Кроме
только: только
этот: этому
супердевайс: супердевайса
появляться: появлялось
установка: установки
различный: различных
улучшать: улучшают
характеристика: характеристики
организм: организм
умственный: умственных
способность: способностей
заканчивать: заканчивая
физический: физическими
происходить: происходит
потому: потому
создавать: создает
непосредственно: непосредственно
дополнительный: дополнительные
точка: точки
выражаться: выражаться
технический: техническим
порт: порты
управление: управления
обеспечивать: обеспечивает
корректный: корректную
их: их
работа: работу
называть: называемые
петля: петли
при: При
человек: человек
становиться: становится
какойнибудь: какимнибудь
киборг: киборгом
ведь: ведь
ни: ни
один: одними
металлический: металлической
пластиковый: пластиковой
деталь: детали
внутри: внутри
девайс: девайсы
создаваться: создавались
ткань: тканей
конкретный: конкретного
потом: потом
надо: надо
ли: ли
говорить: говорить
абсолютно: абсолютно
индивидуум: индивидуумов
жить: живущий
обжитой: обжитом
пространство: пространстве
раса: рас
иметь: имеют
подобный: подобные
вещь: вещи
другой: других
дело: делами
они: они
конечно: конечно
устройство: устройства
какой: каких
средство: средствами
располагать: располагает
клиент: клиент
богатый: богатый
то: то
любезный: любезны
самый: самый
наворотить: навороченный
агрегат: агрегат
сделать: сделает
гений: гений
ну: Ну
нищий: нищий
получить: получите
бесплатный: бесплатный
вариант: вариантов
ничто: ничего
добавить: добавит
идентификация: идентификации
общедоступный: общедоступных
забыть: забудьте
нет: нет
впоследствии: впоследствии
разбогатеть: разбогатеете
милость: милости
просить: просим
апгрейдик: апгрейдик
забацать: забацаем
вытекать: вытекающими
ежели: ежели
естественно: Естественно
ведать: ведали
конкретно: конкретно
корпорация: корпорацией
под: под
название: названию
неиротех: НЕИРОТЕХ
уж: уж
более: более
естественный: естественно
владеть: владели
безраздельно: безраздельно
впрочем: впрочем
филиал: филиалами
территория: территории
государство: государств
находиться: находились
чувачка: чувачки
вообще: вообще
хорошо: хорошо
устроиться: устроились
почивая: Почивая
старый: старых
разработка: разработках
подсадив: подсадив
остальной: остальном
стричь: стригли
купон: купоны
неимоверный: неимоверных
количество: количествах
учитывать: учитывать
продолжительность: продолжительность
жизнь: жизни
население: населения
постоянный: постоянный
прирост: прирост
клиентура: клиентуры
вид: вид
рождаться: рождающихся
увеличивать: увеличивали
свой: своих
благосостояние: благосостояние
исходить: исходя
уже: уже
непонятный: непонятно
изначальното: изначальното
дергаться: дергались
поголовный: поголовным
истребление: истреблением
но: Но
тайна: тайна
покрыть: покрытая
мрак: мраком
видимо: Видимо
старуха: старуху
бывать: бывает
проруха: проруха
тип: Типа
упс: упс
протупилить: протупили
выполнять: выполняет
обучать: обучающую
сроднить: Сродни
позволить: позволила
выучить: выучить
общий: общих
совсем: совсем
знание: знания
накопить: накопленные
разумный: разумными
за: за
время: время
существование: существования
систематизировать: систематизированы
собрать: собраны
некий: некие
база: баз
закачиваться: закачивались
носитель: носителя
желание: желанию
оный: оной
ставиться: ставится
очередь: очередь
обучение: обучение
здорово: Здорово
ты: тебе
заниматься: занимаешься
писаться: пишутся
голова: голову
магнитофон: магнитофоне
лишь: лишь
разница: разницей
стереть: стереть
оттуда: оттуда
можно: можно
овладеть: овладеть
тренировать: тренировать
навык: навыки
пока: пока
стать: станут
собственный: собственные
опыт: опыт
пропить: пропьшь
он: ему
никуда: никуда
деться: денешься
сколько: Сколько
накачай: накачай
подтвердить: подтвердишь
специальный: специальном
учреждение: учреждении
никто: никто
сертификат: сертификат
разрешать: разрешающий
применение: применение
практика: практике
выдать: выдаст
нюанс: нюанс
такой: таких
приблуд: приблуды
достижение: достижения
совершеннолетие: совершеннолетия
ранний: Раньше
нельзя: нельзя
бурно: бурно
развиваться: развивается
поэтому: Поэтому
заведение: заведения
обычный: обычных
земной: земных
школа: школе
ребенок: дети
получать: получают
готовый: готовыми
значить: значит
до: до
маяться: маются
дурь: дурью
типа: Типа
детство: детство
пробегать: пробегал
дурак: дураком
умный: умные
хрен: Хрен
там: там
правильно: правильно
должный: должно
далее: далее
выбирать: выбирает
деятельность: деятельности
согласно: согласно
специализированный: специализированные
иметься: Имеются
природа: природе
включать: Включающие
школьный: школьный
курс: курс
коренной: Коренные
житель: жители
империя: Империя
говориться: говорилось
окружать: окружающем
эмигрант: эмигрантов
вроде: вроде
передаваться: передаются
посредством: посредством
именно: именно
самто: Самто
землянин: землянин
хоть: хоть
знать: знал
являться: являлся
выходец: выходцем
средневековье: средневековья
однако: однако
среди: среди
поток: потока
встречаться: встречаются
порой: порой
темный: тмные
личность: личности
нужный: нужны
илюха: Илюхе
помешать: помешают
понятие: понятий
космос: космоса
вселенная: Вселенной
общество: обществе
закон: законах
всетаки: Встаки
молодец: молодцы
местный: местные
позаботиться: позаботились
дикарь: дикарях
узкоспециализированный: узкоспециализированными
поголовно: поголовно
наполовину: наполовину
юрист: юрист
даун: даун
хотеть: хочет
видеть: видеть
поддать: подданных
балбес: балбесов
представлять: Представляем
внимание: вниманию
похожий: похожие
отобрать: отобрали
схожий: схожую
литература: литературу
надежда: надежде
предоставить: предоставить
читатель: читателей
больше: больше
интересный: интересные
обсуждение: Обсуждение
просто: просто
мнение: мнения
оставить: Оставьте
думать: думаете
главный: главных
указать: Укажите
понравиться: понравилось
считать: считаете
