заголовок: Заголовок
олег: Олег
данильченко: Данильченко
имперский: Имперский
вояж: вояж
читать: читать
онлайн: онлайн
бесплатно: бесплатно
адрес: Адрес
здесь: Здесь
быть: была
возможность: Возможность
весь: вс
текст: текст
электронный: электронной
книга: книге
совершенно: совершенно
целиком: целиком
полный: полный
версия: версию
в: в
некоторый: некоторых
случай: случаях
присутствовать: присутствует
краткий: краткое
содержание: содержание
город: Город
м: М
спб: СПб
год: года
выпуск: выпуска
издательство: издательство
аста: АСТ
издательский: Издательский
дом: дома
ленинград: Ленинград
категория: категорию
боевой: боевой
фантастика: фантастика
космический: Космическая
на: на
русский: русском
язык: языке
описание: описание
произведение: произведении
предисловие: предисловие
а: а
так: так
же: же
отзыв: отзывы
посетитель: посетителей
доступный: доступны
портал: портале
библиотека: Библиотека
либ: Либ
кат: Кат
создать: создана
для: для
любитель: любителей
полистать: полистать
хороший: хорошую
книжка: книжку
и: и
предлагать: Предлагаем
широкий: широкий
выбор: выбора
жанр: жанров
любовный: любовные
роман: романы
фэнтези: фэнтези
приключение: приключения
детектив: детективы
триллер: триллеры
эротика: эротика
документальный: документальные
научный: научные
юмористический: юмористические
анекдот: анекдоты
о: о
бизнес: бизнесе
проза: проза
детский: детские
сказка: сказки
религиия: религиии
новинка: новинки
православный: православные
старинный: старинные
про: про
компьютер: компьютеры
программирование: программирование
английский: английском
домоводство: домоводство
поэзия: поэзия
выбрав: Выбрав
по: по
душа: души
вы: Вы
смочь: сможете
найти: нашли
действительно: действительно
стоить: стоящие
насладиться: насладиться
погружение: погружением
мир: мир
воображение: воображения
прочувствовать: прочувствовать
переживание: переживания
герой: героях
или: или
узнать: Узнайте
себя: себе
чтото: чтото
новый: новые
совершить: совершить
внутренний: внутреннее
открытие: открытие
подробный: Подробная
информация: информацию
ознакомление: ознакомления
текущий: текущему
запрос: запросу
представить: представлен
низкий: Ниже
к: к
чтение: чтение
аннотация: аннотацию
зависеть: зависит
от: от
тот: тот
что: что
написать: напишите
сам: самом
автор: автора
если: Если
не: не
необходимый: необходимую
комментарий: комментарии
мы: Мы
постараться: постараемся
отыскать: отыскать
она: она
кто: Кто
фамилия: фамилию
как: как
звать: зовут
список: списком
его: его
серия: сериям
уважаемые: Уважаемые
правообладатель: правообладатели
размещать: размещать
наш: нашем
сайт: сайте
у: у
любой: любой
зарегистрировать: зарегистрированного
пользователь: пользователя
ваш: ваши
опубликовать: опубликована
без: без
согласие: согласия
пожалуйста: пожалуйста
направить: направьте
жалоба: жалобу
заполните: заполните
форма: форму
обратный: обратной
связь: связи
течение: течение
час: часов
закрыть: закроем
доступ: доступ
нелегально: нелегально
разместить: размещенному
контент: контенту
разбить: разбитый
страница: страницу
система: Система
сохранение: сохранения
место: места
последний: последней
прочитать: прочитанные
позволять: позволяет
с: с
удобство: удобством
необходимость: необходимости
каждый: каждый
раз: раз
заново: заново
искать: искать
остановиться: остановились
поставить: Поставьте
закладка: Закладка
момент: момент
перейти: перейти
который: которое
закончить: закончить
шрифт: Шрифт
интервал: Интервал
однажды: Однажды
ящик: ящику
довестись: довелось
посмотреть: посмотреть
занимательный: занимательную
передача: передачи
где: где
показывать: показывали
дорожный: дорожные
курьез: курьезы
смешной: смешные
авария: аварии
подобный: подобное
вот: вот
один: один
сюжет: сюжет
запомниться: запомнился
особо: особо
суть: Суть
какойто: какогото
урод: урод
припарковать: припарковал
свой: своего
джип: джип
возле: возле
арочный: арочного
проезд: проезд
перегородить: перегородив
дорога: дорогу
другой: другой
водитель: водитель
надо: надо
проехать: проехать
двор: двор
недолго: недолго
думать: думаете
достать: достал
буксир: буксир
зацепить: зацепил
мешать: мешающий
транспорт: транспорт
оттащить: оттащил
сторона: сторону
сказать: сказал
освободить: освободил
ведущий: ведущий
тип: типа
справедливо: Справедливо
но: но
незаконно: незаконно
этот: эта
слово: слова
поразить: поразили
до: до
глубина: глубины
какой: Какие
это: этого
пора: пор
понятие: понятия
справедливость: справедливости
вдруг: вдруг
стать: стало
незаконный: незаконным
происходить: происходит
человек: людьми
куда: куда
катиться: катится
такой: таких
переворачивать: переворачивают
нога: ног
голова: голова
да: Да
ладно: ладно
дело: деле
прошлое: прошлое
общий: общем
насчет: насчт
отчисление: отчисления
горевать: горевал
илюха: Илюха
ровно: ровно
пять: пять
минута: минут
после: после
подать: подал
документ: документы
мореходный: мореходную
школа: школу
через: через
должность: должности
моторист: моториста
уйти: ушел
море: морях
работа: Работа
нравиться: нравилась
кормить: Кормят
поить: поят
одевать: одевают
вовремя: вовремя
менять: меняют
пеленка: пеленки
возить: возят
заграница: заграницам
еще: ещ
деньга: деньги
платить: платят
красота: красота
радужный: радужно
конечно: конечно
работать: работать
выходной: выходных
праздник: праздников
часто: часто
вахта: вахты
буде: буде
аврал: аврал
образоваться: образовался
мелочь: мелочи
илья: Илья
внимание: вниманию
обращать: обращал
целый: целые
два: два
охотиться: охотился
за: за
впечатление: впечатлениями
из: из
рейс: рейс
получить: получил
телеграмма: телеграмму
извещали: извещали
смерть: смерти
отец: Отца
пароход: парохода
подводный: подводной
лодка: лодки
деться: деться
некуда: некуда
только: только
месяц: месяц
удаться: удалось
сойти: сойти
берег: берег
уже: уже
похоронить: похоронили
погибнуть: Погиб
он: Ему
спасать: спасая
молодой: молодого
боец: Боец
когда: когда
учение: учениях
справиться: справился
граната: гранатой
остаться: остался
живой: жив
батя: батя
наследство: Наследства
квартира: квартира
ведомственный: ведомственная
вещь: вещей
тоже: тоже
медаль: медали
сбережение: сбережения
кот: кот
наплакать: наплакал
образ: образом
совсем: совсем
жизнь: жизнь
закончиться: закончилась
военкомат: военкомат
никуда: никуда
исчезнуть: исчезли
короче: Короче
пока: пока
парень: парень
охота: охота
увенчаться: увенчалась
успех: успехом
успеть: успел
смыться: смыться
очередной: очередной
подхватить: подхватили
под: под
бел: белы
рученька: рученьки
говориться: говорится
забрить: забрили
солдат: солдаты
далекий: Дальше
учебка: учебка
чечня: Чечня
плен: плен
глава: Глава
войнушка: войнушка
бестолковый: бестолковой
мнение: мнения
можно: можно
очень: очень
быстро: быстро
видимо: видимо
ктото: комуто
выгодный: выгодной
иначе: Иначе
объяснить: объяснить
получаться: получается
например: Например
поступать: поступает
приказ: приказах
уничтожить: уничтожить
бандформирование: бандформирование
самый: самое
формирование: формирование
окружить: окружено
оставаться: остаются
отмена: отмена
бандит: бандиты
спокойно: спокойно
уходить: уходят
гора: горы
пример: примеров
масса: масса
говорить: говоря
идиотский: идиотских
благодаря: благодаря
подразделение: подразделения
российский: российских
войско: войск
попадать: попадали
засада: засаду
вырезаться: вырезались
подчистую: подчистую
никак: никак
уж: уж
тут: тут
объяснение: объяснения
дурак: Дурак
равный: равно
понять: поймт
умный: умному
объяснять: объяснять
угодить: угодили
кура: кур
ощип: ощип
картинка: Картинки
событие: событий
мелькать: мелькают
память: памяти
словно: словно
кадр: кадры
кинохроника: кинохроники
сидеть: сидит
броня: броне
бтр: БТР
колонна: колонны
идти: идет
грозный: Грозный
там: там
отбиваться: отбиваются
попасть: попавшие
спецназовец: спецназовцы
взрыв: взрывом
подбрасывать: подбрасывает
кверху: кверху
перед: перед
головной: головной
машина: машины
взрывной: взрывной
волна: волной
буквально: Буквально
сдувать: сдувает
бронь: брони
вслед: вслед
ехать: ехал
вспухать: вспухает
огненный: огненным
шар: шаром
лишь: лишь
жирно: жирно
чадить: чадящие
остов: остовы
остаток: остатками
волочить: волоча
раненый: раненых
пробиваться: пробивается
туда: туда
все: вс
держаться: держатся
спец: спецы
бой: бой
полуразрушить: полуразрушенной
пятиэтажка: пятиэтажке
лупить: лупит
короткий: короткими
очередь: Очередь
боевик: боевика
высунуться: высунувшегося
изза: изза
бетонный: бетонного
блок: блока
взрываться: взрывается
кровавый: кровавыми
брызги: брызгами
второй: второй
нападающий: нападающий
громко: громко
завывать: завывая
падать: падает
груда: груду
битый: битого
кирпич: кирпича
хвататься: хватаясь
разворотить: развороченное
левый: левое
бедро: бедро
третий: Третья
хрен: хрен
сухой: сухой
щелчок: щелчок
боек: бойка
возвестить: возвестил
стрелять: стреляет
большой: больше
нечего: нечем
хлопать: хлопает
карман: карманам
разгрузка: разгрузки
пустой: Пустой
кричать: кричит
держать: Держи
откудато: Откудато
справа: справа
прилетать: прилетает
магазин: магазин
подхватывать: подхватывает
подсоединять: подсоединяет
затвор: затвор
сытый: сыто
лязгать: лязгает
досылая: досылая
смертельный: смертельный
подарок: подарок
патронник: патронник
оглядываться: оглядывается
откуда: откуда
прилететь: прилетел
подмигивать: подмигивает
единственный: единственный
глаз: глаз
капитан: капитана
заплыть: заплыл
огромный: огромной
гематома: гематомой
лупаета: лупает
блестеть: блестит
веселый: веслой
злость: злостью
дрейфить: дрейфь
сержант: сержант
покочевряжиться: покочевряжимся
слышаться: слышится
спокойный: спокойный
голос: голос
дрейфит: дрейфит
ситуация: ситуациях
страх: Страх
нет: нет
адреналин: адреналин
ухо: ушей
хлестать: хлещет
отходняк: отходняк
откат: откат
называть: называйте
хотеть: хотите
приходить: приходит
потом: потом
просто: просто
время: времени
осмысливать: осмысливать
положение: положение
они: они
представлять: Представляем
похожий: похожие
отобрать: отобрали
схожий: схожую
название: названию
смысл: смысле
литература: литературу
надежда: надежде
предоставить: предоставить
читатель: читателей
больше: больше
вариант: вариантов
интересный: интересные
обсуждение: Обсуждение
собственный: собственные
оставить: Оставьте
главный: главных
указать: Укажите
конкретно: конкретно
понравиться: понравилось
почему: почему
считать: считаете
