заголовок: Заголовок
олег: Олег
данильченко: Данильченко
имперский: Имперский
вояж: вояж
читать: читать
онлайн: онлайн
бесплатно: бесплатно
адрес: Адрес
здесь: Здесь
быть: будь
возможность: возможность
весь: вс
текст: текст
электронный: электронной
книга: книге
совершенно: совершенно
целиком: целиком
полный: полную
версия: версию
в: в
некоторый: некоторых
случай: случаях
присутствовать: присутствует
краткий: краткое
содержание: содержание
город: Город
м: М
спб: СПб
год: год
выпуск: выпуска
издательство: издательство
аста: АСТ
издательский: Издательский
дом: дом
ленинград: Ленинград
категория: категорию
боевой: Боевая
фантастика: фантастика
космический: космических
на: на
русский: русском
язык: языке
описание: описание
произведение: произведении
предисловие: предисловие
а: а
так: так
же: же
отзыв: отзывы
посетитель: посетителей
доступный: доступные
портал: портале
библиотека: Библиотека
либ: Либ
кат: Кат
создать: создана
для: для
любитель: любителей
полистать: полистать
хороший: лучшая
книжка: книжку
и: и
предлагать: Предлагаем
широкий: широкий
выбор: выбора
жанр: жанров
любовный: любовные
роман: романы
фэнтези: фэнтези
приключение: приключения
детектив: детективы
триллер: триллеры
эротика: эротика
документальный: документальные
научный: научные
юмористический: юмористические
анекдот: анекдоты
о: о
бизнес: бизнесе
проза: проза
детский: детские
сказка: сказки
религиия: религиии
новинка: новинки
православный: православные
старинный: старинные
про: про
компьютер: компьютеры
программирование: программирование
английский: английском
домоводство: домоводство
поэзия: поэзия
выбрав: Выбрав
по: по
душа: душе
вы: Вы
смочь: смог
найти: нашли
действительно: действительно
стоить: стоит
насладиться: насладиться
погружение: погружением
мир: мир
воображение: воображения
прочувствовать: прочувствовать
переживание: переживания
герой: героях
или: или
узнать: узнав
себя: себе
чтото: чтото
новый: новые
совершить: совершить
внутренний: внутренних
открытие: открытие
подробный: Подробная
информация: информацию
ознакомление: ознакомления
текущий: текущему
запрос: запросу
представить: представлен
низкий: Ниже
к: ко
чтение: чтение
аннотация: аннотацию
зависеть: зависит
от: от
тот: то
что: что
написать: напишите
сам: Само
автор: автора
если: если
не: не
необходимый: необходимо
комментарий: комментарии
мы: Мы
постараться: постараемся
отыскать: отыскать
она: е
кто: кто
фамилия: фамилию
как: как
звать: зовут
список: списком
его: его
серия: сериям
уважаемые: Уважаемые
правообладатель: правообладатели
размещать: размещать
наш: нашем
сайт: сайте
у: У
любой: любые
зарегистрировать: зарегистрированного
пользователь: пользователя
ваш: ваши
опубликовать: опубликована
без: без
согласие: согласия
пожалуйста: пожалуйста
направить: направьте
жалоба: жалобу
заполните: заполните
форма: форму
обратный: обратной
связь: связи
течение: течение
час: час
закрыть: закроем
доступ: доступ
нелегально: нелегально
разместить: размещенному
контент: контенту
разбить: разбитый
страница: страницу
система: Система
сохранение: сохранения
место: места
последний: последняя
прочитать: прочитанные
позволять: позволяет
с: с
удобство: удобством
необходимость: необходимости
каждый: каждый
раз: раз
заново: заново
искать: искать
остановиться: остановились
поставить: поставленным
закладка: Закладка
момент: момент
перейти: перейти
который: котором
закончить: закончили
шрифт: Шрифт
интервал: Интервал
встать: Встать
сержант: сержант
смирный: Смирно
команда: Команда
хлестнуть: хлестнула
выстрел: выстрел
неожиданно: неожиданно
громко: громко
илюха: Илюха
автомат: автомате
вздернуться: вздрнулся
стул: стула
сидеть: сидел
выполнять: выполняя
приказ: приказ
слететь: Слетело
наваждение: наваждение
илья: Илья
наконец: наконец
осознать: осознать
происходить: происходит
вокруг: вокруг
плакать: плачет
энди: Энди
человек: Люди
проходить: проходить
это: это
мимо: мимо
шарахнуться: шарахнулись
сторона: стороны
ты: тебя
раскиснуть: раскис
элио: элио
рявкнуть: рявкнул
джойло: Джойл
снова: Снова
подумать: Подумаешь
интеллект: интеллект
всего: всего
сто: сто
десять: десять
ну: ну
сразу: сразу
сопля: сопли
кулак: кулак
мотать: мотать
сетка: сетку
десятка: десятку
добавить: добавить
твой: твой
минимум: минимум
сейчас: Сейчас
метнуться: метнмся
нейротех: Нейротех
посмотреть: посмотрим
они: ими
мочь: могу
предложить: предложить
имплант: имплант
прикупить: прикупим
я: мне
сотня: сотню
конечно: конечно
но: Но
полтинничек: полтинничек
думать: думаете
взять: возьмм
высоко: Выше
нос: нос
боец: боец
цеплять: цепляй
свой: своим
ненаглядный: ненаглядного
буксир: буксир
ехать: едем
яйцеголов: яйцеголовым
флаер: флаер
лет: лту
вот: вот
еще: ещ
один: один
стеклянный: стеклянный
параллелепипед: параллелепипед
девушка: девушкой
ресепшен: ресепшене
мило: мило
улыбаться: улыбаясь
обращать: обращая
гневный: гневные
взгляд: взгляды
зеленый: зелных
глаз: глаз
ровный: ровным
счет: счтом
никакой: никакого
внимание: вниманию
поинтересоваться: поинтересовалась
ли: ли
помочь: помочь
прибыть: прибыл
чтобы: чтобы
выбрать: выбрать
установить: установить
первый: первая
нейросеть: нейросети
обрадоваться: обрадовалась
родный: родному
пригласить: пригласила
кабинет: кабинете
специалист: специалисту
разъяренный: разъяренной
остаться: остались
прохладный: прохладном
фойе: фойе
последовать: последовал
за: за
оказаться: оказался
светлый: светлом
удобный: удобном
кресло: кресле
перед: Перед
он: ним
запотеть: запотевший
стакан: стакан
какойто: какието
сок: сока
итак: Итак
понимать: понимаю
программа: программе
эмиграционный: эмиграционного
центр: центра
спросить: спросил
молодой: молодой
гладко: гладко
выбрить: выбритый
мужчина: мужчина
хорошо: хорошо
голос: голосом
верно: Верно
ответить: ответил
кивать: кивая
иметь: имеет
пожелание: пожелания
устанавливать: устанавливать
бесплатный: бесплатную
уточнить: уточнил
менеджер: менеджер
желание: желание
стать: стать
пилот: пилотов
хватать: хватает
врожденный: врожднного
надеяться: надеюсь
после: после
установка: установки
набрать: наберу
посоветовать: посоветовал
хм: Хм
тут: тут
какой: какими
средство: Средств
располагать: располагаете
предложитьто: Предложитьто
много: много
сильно: сильно
ограничиться: ограничиться
время: время
сеть: сеть
пятый: пятого
поколение: поколения
такой: такие
иметься: имеется
говорить: говорит
также: также
можно: можно
подразогнать: подразогнать
отличаться: отличаются
шестой: шестого
както: както
ключ: ключе
давать: дающая
совет: советы
заслуживать: заслуживает
всяческий: всяческих
похвала: похвал
очень: очень
грамотный: грамотные
надо: надо
отдать: отдать
должное: должное
вариант: вариантов
пилот: Пилот
мс: МС
му: МУ
муэлита: МУЭлит
пояснить: Поясните
попросить: попросил
легкий: Легко
смотреть: смотрите
модернизировать: модернизированная
предназначить: предназначенная
узкоспециализированный: узкоспециализированных
требовать: требующая
специализация: специализации
отсюда: отсюда
аббревиатура: аббревиатура
ставить: ставят
точно: точно
знать: знает
предстоять: предстоит
летать: летать
другой: Другие
корабль: корабли
недоступный: недоступны
поднимать: поднимает
восемнадцать: восемнадцать
пункт: пунктов
два: две
точка: точки
подключение: подключения
имплантат: имплантатов
объем: объеме
память: памяти
носитель: носителей
небольшой: невелик
нужный: нужно
расширить: расширенные
знание: знаний
оснащение: оснащении
требоваться: требуется
сорок: сорок
тысяча: тысяч
кредит: кредитов
далее: Далее
второй: вторая
практически: практически
самый: самое
там: там
означать: означает
универсальный: универсальная
слово: слово
этот: эта
изучать: изучать
управлять: управлять
естественно: Естественно
гораздо: гораздо
больше: больше
петля: Петель
уже: уже
три: три
дорогой: дороже
пятьдесят: пятьдесят
несомненно: несомненно
из: из
полностью: полностью
повторять: повторяет
предыдущий: предыдущую
характеристика: характеристикам
главный: главных
встроить: встроенная
функция: функция
база: базе
технический: технического
уровень: уровня
приемлемый: приемлемой
скорость: скоростью
работать: работать
специальность: специальности
инженертехник: инженертехник
правда: правда
невысокий: невысокого
ранг: ранга
плюс: Плюс
двадцать: двадцать
существенный: существенную
разница: разницу
даже: даже
сравнение: сравнению
тоже: тоже
шестьдесят: шестьдесят
четыре: четыре
бы: бы
именно: именно
разгон: разгоном
разуметься: Разумеется
готовый: готовы
восемь: восемь
то: то
бонус: бонусом
пойти: пойдут
общий: общие
совсем: совсем
отдельный: отдельную
плата: плату
предоставить: предоставить
легально: легально
профильный: профильные
нет: нет
спасибо: спасибо
пока: пока
собираться: собираюсь
обучение: обучение
войсковой: войсковой
резерв: резерва
получить: получу
представлять: Представляем
похожий: похожие
отобрать: отобрали
схожий: схожую
название: названию
смысл: смысле
литература: литературу
надежда: надежде
читатель: читателей
интересный: интересные
обсуждение: Обсуждение
просто: просто
собственный: собственные
мнение: мнения
оставить: Оставьте
указать: Укажите
конкретно: конкретно
понравиться: понравилось
почему: почему
считать: считаете
