заголовок: Заголовок
олег: Олег
данильченко: Данильченко
имперский: Имперский
вояж: вояж
читать: читать
онлайн: онлайн
бесплатно: бесплатно
адрес: адрес
здесь: здесь
быть: было
возможность: Возможность
весь: весь
текст: текст
электронный: электронной
книга: книге
совершенно: совершенно
целиком: целиком
полный: полную
версия: версию
в: в
некоторый: некоторых
случай: случаях
присутствовать: присутствует
краткий: краткое
содержание: содержание
город: Город
м: М
спб: СПб
год: год
выпуск: выпуска
издательство: издательство
аста: АСТ
издательский: Издательский
дом: дом
ленинград: Ленинград
категория: категорию
боевой: Боевая
фантастика: фантастика
космический: Космическая
на: на
русский: русском
язык: язык
описание: описание
произведение: произведении
предисловие: предисловие
а: а
так: так
же: же
отзыв: отзывы
посетитель: посетителей
доступный: доступны
портал: портале
библиотека: Библиотека
либ: Либ
кат: Кат
создать: создана
для: для
любитель: любителей
полистать: полистать
хороший: Хорошо
книжка: книжку
и: и
предлагать: Предлагаем
широкий: шире
выбор: выбора
жанр: жанров
любовный: любовные
роман: романы
фэнтези: фэнтези
приключение: приключения
детектив: детективы
триллер: триллеры
эротика: эротика
документальный: документальные
научный: научные
юмористический: юмористические
анекдот: анекдоты
о: о
бизнес: бизнесе
проза: проза
детский: детские
сказка: сказки
религиия: религиии
новинка: новинки
православный: православные
старинный: старинные
про: про
компьютер: компьютеры
программирование: программирование
английский: английском
домоводство: домоводство
поэзия: поэзия
выбрав: Выбрав
по: по
душа: душе
вы: Вы
смочь: смог
найти: найдя
действительно: действительно
стоить: стоило
насладиться: насладиться
погружение: погружением
мир: мир
воображение: воображения
прочувствовать: прочувствовать
переживание: переживания
герой: героях
или: или
узнать: Узнайте
себя: себя
чтото: чтото
новый: новые
совершить: совершить
внутренний: внутреннее
открытие: открытие
подробный: Подробная
информация: информации
ознакомление: ознакомления
текущий: текущему
запрос: запросу
представить: представлен
низкий: Ниже
к: к
чтение: чтение
аннотация: аннотацию
зависеть: зависит
от: от
тот: той
что: что
написать: напишите
сам: сама
автор: автора
если: если
не: не
необходимый: необходимую
комментарий: комментарии
мы: Мы
постараться: постараемся
отыскать: отыскать
она: она
кто: кто
фамилия: фамилию
как: как
звать: зовут
список: списком
его: его
серия: сериям
уважаемые: Уважаемые
правообладатель: правообладатели
размещать: размещать
наш: нашем
сайт: сайте
у: У
любой: любой
зарегистрировать: зарегистрированного
пользователь: пользователя
ваш: ваши
опубликовать: опубликована
без: без
согласие: согласия
пожалуйста: пожалуйста
направить: направьте
жалоба: жалобу
заполните: заполните
форма: форму
обратный: обратной
связь: связи
течение: течение
час: часов
закрыть: закрыли
доступ: доступ
нелегально: нелегально
разместить: размещенному
контент: контенту
разбить: разбитый
страница: страницу
система: Система
сохранение: сохранения
место: места
последний: последнее
прочитать: прочитанные
позволять: позволяет
с: с
удобство: удобством
необходимость: необходимости
каждый: каждый
раз: раз
заново: заново
искать: искать
остановиться: остановились
поставить: Поставьте
закладка: Закладка
момент: момент
перейти: перейти
который: которую
закончить: закончили
шрифт: Шрифт
интервал: Интервал
да: Да
я: я
принцип: принципе
против: против
хотя: хотя
особый: особого
голод: голода
чувствовать: чувствовал
ну: Ну
заказать: закажем
чтонибудь: чегонибудь
легкий: лгкого
выпьем: выпьем
немного: немного
пообщаться: пообщаемся
естественно: Естественно
ответить: отвечу
мой: мои
вопрос: вопросы
конечно: Конечно
за: за
исключение: исключением
секретный: секретной
поделиться: поделюсь
знать: знаю
идемте: Идмте
столовая: Столовая
встретить: встретила
гул: гулом
голос: голосом
отличие: отличие
первый: первого
посещение: посещения
сейчас: сейчас
людный: людно
выбрать: выбрать
столик: столик
такто: такто
простой: просто
пойдемте: Пойдмте
вон: вон
туда: туда
указать: Укажите
направление: направление
грег: Грег
там: там
похоже: Похоже
свободный: свободна
стол: столом
но: но
начать: начать
движение: движение
дорога: дорогу
перегородить: перегородил
здоровенный: здоровенного
детина: детина
черный: чрном
комбинезон: комбинезоне
два: два
метр: метр
рост: росту
говориться: говорится
поперек: поперк
огненнорыжий: огненнорыжей
шевелюра: шевелюрой
веснушчатый: веснушчатым
лицо: лицом
это: ЭТО
мясо: мясо
вынуть: вынули
из: из
фрегат: фрегата
обратиться: обратился
он: он
доку: доку
густой: густым
бас: бас
даже: даже
скорый: скорее
прогудел: прогудел
илья: Илья
считать: считаете
маленький: маленький
чай: чай
сантиметр: сантиметра
кепка: кепкой
рядом: рядом
этот: этот
человек: человеком
заморыш: заморышем
джойло: Джойла
именно: именно
ты: ты
лично: лично
решить: решил
познакомиться: познакомиться
вот: Вот
еще: ещ
много: Много
честь: чести
сосунок: Сосунок
сжать: сжал
кулак: Кулак
понимать: понимал
какойто: какаято
постановка: постановка
видно: Видно
громила: громилы
работать: работает
публика: публику
хотеть: хочешь
развлекалов: развлекалова
цирк: цирк
вслух: вслух
сказать: сказал
док: Док
обращаться: обращайся
уже: уже
рыжий: рыжий
кингконг: КингКонгу
орясина: орясина
слово: Словами
произнести: произнс
общий: общем
аналог: аналога
какой: какие
сразу: сразу
только: только
посмотреть: посмотрите
тыкать: тыкал
палец: пальцем
сторона: сторону
оно: оно
разговаривать: разговаривает
подтвердить: подтвердил
вывод: вывод
облом: облома
илюха: Илюха
причем: причем
зуб: зубы
выбивать: выбивать
уметь: умеет
случайно: случайно
жать: жмут
зал: зал
притихнуть: притих
видимо: видимо
представление: представление
пойти: пошло
неожиданный: неожиданному
сценарий: сценарию
прогудеть: прогудел
гигант: гигант
прекрасно: прекрасно
вряд: вряд
ли: ли
справиться: справится
такой: такое
гора: гора
мышца: мышц
более: более
явно: явно
надувной: надувная
очень: очень
способный: способная
перемолоть: перемолоть
пара: пару
секунда: секунд
терпеть: терпеть
издевательство: издевательства
свой: своему
тоже: тоже
собираться: собирался
единственный: Единственный
шанс: шанс
разозлить: разозлить
оппонент: оппонента
вынудить: вынудить
безрассудный: безрассудные
действие: действия
притворно: притворно
расслабить: расслабленной
поза: позой
тогда: Тогда
мочь: может
появиться: появиться
свалить: свалил
глыба: глыбу
один: одним
удар: удара
потом: Потом
поэтому: Поэтому
продолжить: продолжил
нагнетать: нагнетать
обстановка: обстановку
придать: Придав
большой: больше
издевательский: издевательских
нотка: ноток
глухой: глухой
флотто: флотто
взять: взяли
заплатить: заплатить
прийтись: пришлась
чтобы: чтобы
глаз: глаз
твой: твоя
глухота: глухоту
скудоумие: скудоумие
повиснуть: повисла
звенящий: звенящая
тишина: тишине
труп: труп
свистящий: свистящим
шепот: шпот
просипеть: просипел
между: между
нога: ног
убийца: убийца
старушка: старушек
соснуть: соснуть
униматься: унимался
ударить: ударил
коротко: коротко
замах: замаха
быстрый: быстр
настолько: настолько
бы: бы
готовиться: готовился
заранее: заранее
то: то
пропустить: пропустил
подача: подачу
почти: почти
боец: бойца
выдать: выдало
начало: начале
пролететь: пролетел
над: над
голова: головой
доля: долях
миллиметр: миллиметра
задеть: задев
волос: волосы
поднырнув: Поднырнув
под: под
атаковать: атакующую
рука: руку
действовать: действовал
рефлекс: рефлексах
когдато: когдато
давно: давно
вбить: вбитых
отец: отцом
тренировка: тренировках
рукопашный: рукопашному
бой: бою
сделать: сделала
нужный: нужную
точка: точку
вложить: вложил
накопиться: накопилось
время: время
ненависть: Ненависть
держать: держал
плен: плену
скорбь: скорбь
погибнуть: погибшим
сослуживец: сослуживцам
боль: боль
помочь: помочь
раненый: раненому
друг: другу
все: ВС
стать: стало
ядро: ядром
ярость: ярости
вид: виде
точно: точно
солнышко: солнышко
выдающийся: выдающегося
мышечный: мышечного
каркас: каркаса
уносить: уносили
двухсотый: двухсотого
сесть: сел
задница: задницу
хватать: хватая
рот: ртом
воздух: воздух
удивленно: удивленно
хлопая: хлопая
длиннющий: длиннющими
ресница: ресницы
странно: Странно
они: их
вообще: вообще
заметить: заметил
ситуация: ситуации
удивительно: Удивительно
мужик: мужика
многие: многие
девка: девки
обзавидоваться: обзавидовались
раздаться: раздался
чейто: чейто
удивленный: удивленный
болеть: болела
ощущение: ощущение
бить: бил
камень: камню
хотеться: Хотелось
орать: орать
больно: больно
собрать: собрав
воля: волю
куча: кучу
изобразить: изобразил
веселый: веслую
улыбка: улыбку
тут: тут
удивительный: удивительного
родина: родине
говорить: говорят
чем: Чем
больше: больше
шкаф: шкаф
тем: тем
громкий: громче
падать: падает
повернуться: повернулся
оторопеть: оторопевшему
доктор: доктору
беззаботный: беззаботным
спросить: спросил
чудокапсула: чудокапсула
думать: думаете
снова: снова
понадобиться: понадобится
сломать: сломал
грохнуть: грохнул
ржать: Ржали
лечь: лг
кататься: катался
держаться: держась
живот: живот
смех: смеха
сползать: сползал
переборка: переборке
испуг: испуге
опереться: оперся
спина: спиной
инцидент: инцидента
самый: самое
главный: главных
шумный: шумный
всеобщий: всеобщий
хохот: хохот
перекрывать: перекрывал
громовой: громовой
смеющегося: смеющегося
представлять: Представляем
внимание: вниманию
похожий: похожие
отобрать: отобрали
схожий: схожую
название: названию
смысл: смысле
литература: литературу
надежда: надежде
предоставить: предоставить
читатель: читателей
вариант: вариантов
интересный: интересные
обсуждение: Обсуждение
просто: просто
собственный: собственные
мнение: мнения
оставить: Оставьте
конкретно: конкретно
понравиться: понравилось
нет: нет
почему: почему
