заголовок: Заголовок
олег: Олег
данильченко: Данильченко
имперский: Имперский
вояж: вояж
читать: читать
онлайн: онлайн
бесплатно: бесплатно
адрес: Адрес
здесь: Здесь
быть: были
возможность: возможность
весь: Все
текст: текст
электронный: электронной
книга: книге
совершенно: совершенно
целиком: целиком
полный: полную
версия: версию
в: в
некоторый: некоторых
случай: случае
присутствовать: присутствует
краткий: краткое
содержание: содержание
город: Город
м: М
спб: СПб
год: год
выпуск: выпуска
издательство: издательство
аста: АСТ
издательский: Издательский
дом: дом
ленинград: Ленинград
категория: категорию
боевой: боевых
фантастика: фантастика
космический: Космическая
на: на
русский: русском
язык: языке
описание: описание
произведение: произведении
предисловие: предисловие
а: а
так: так
же: же
отзыв: отзывы
посетитель: посетителей
доступный: доступны
портал: портале
библиотека: Библиотека
либ: Либ
кат: Кат
создать: создать
для: для
любитель: любителей
полистать: полистать
хороший: хорошо
книжка: книжку
и: и
предлагать: Предлагаем
широкий: широкий
выбор: выбора
жанр: жанров
любовный: любовные
роман: романы
фэнтези: фэнтези
приключение: приключения
детектив: детективы
триллер: триллеры
эротика: эротика
документальный: документальные
научный: научные
юмористический: юмористические
анекдот: анекдоте
о: о
бизнес: бизнесе
проза: проза
детский: детские
сказка: сказки
религиия: религиии
новинка: новинки
православный: православные
старинный: старинные
про: про
компьютер: компьютеры
программирование: программирование
английский: английском
домоводство: домоводство
поэзия: поэзия
выбрав: Выбрав
по: по
душа: душе
вы: Вы
смочь: смогу
найти: нашел
действительно: действительно
стоить: стоить
насладиться: насладиться
погружение: погружением
мир: мир
воображение: воображения
прочувствовать: прочувствовать
переживание: переживания
герой: героях
или: или
узнать: Узнайте
себя: себе
чтото: чтото
новый: новые
совершить: совершить
внутренний: внутреннее
открытие: открытие
подробный: Подробная
информация: информацию
ознакомление: ознакомления
текущий: текущему
запрос: запросу
представить: представлен
низкий: Ниже
к: к
чтение: чтение
аннотация: аннотацию
зависеть: зависит
от: от
тот: том
что: что
написать: напишите
сам: сам
автор: автора
если: если
не: не
необходимый: необходимую
комментарий: комментарии
мы: Мы
постараться: постарался
отыскать: отыскать
она: она
кто: Кто
фамилия: фамилию
как: как
звать: зовут
список: списком
его: его
серия: сериям
уважаемые: Уважаемые
правообладатель: правообладатели
размещать: размещать
наш: наших
сайт: сайте
у: у
любой: любом
зарегистрировать: зарегистрированного
пользователь: пользователя
ваш: ваши
опубликовать: опубликована
без: без
согласие: согласия
пожалуйста: пожалуйста
направить: направьте
жалоба: жалобу
заполните: заполните
форма: форму
обратный: обратной
связь: связи
течение: течение
час: часов
закрыть: закроем
доступ: доступ
нелегально: нелегально
разместить: размещенному
контент: контенту
разбить: разбитый
страница: страницу
система: Система
сохранение: сохранения
место: места
последний: последней
прочитать: прочитанные
позволять: позволяет
с: со
удобство: удобством
необходимость: необходимости
каждый: каждый
раз: раз
заново: заново
искать: искать
остановиться: остановились
поставить: Поставьте
закладка: Закладка
момент: момент
перейти: перейти
который: которой
закончить: закончили
шрифт: Шрифт
интервал: Интервал
нет: нет
ты: тебе
удивиться: удивился
собеседник: собеседник
такой: такое
функция: функция
иметься: имеется
скафандр: скафандра
зачем: зачем
встраивать: встраивать
нейросеть: нейросетей
они: они
дорогой: дорогие
лишний: лишнее
только: только
тормозить: тормозить
быстродействие: быстродействие
я: мне
слышать: слышать
но: но
ведь: ведь
потребность: потребность
свой: своей
защита: защите
частый: чаще
возникать: возникает
неожиданно: неожиданно
возразить: возразил
илья: Илья
под: под
рука: рукой
мочь: можешь
оказаться: оказаться
этот: эти
подобный: подобная
бы: бы
очень: очень
полезный: полезной
находить: находишь
да: Да
это: этого
понятный: понятно
насколько: насколько
знать: знает
делать: делают
усовершенствование: усовершенствования
практически: практически
исчерпать: исчерпали
ученый: учные
пытаться: пытаются
более: более
мощный: мощное
пока: пока
удаваться: удатся
даже: даже
удаться: удастся
то: то
представлять: Представляем
сколько: сколько
игрушка: игрушка
процент: Процент
нападение: нападения
мирный: мирных
человек: человек
заставлять: заставляющий
применять: применять
личный: личное
оружие: оружие
статистика: статистике
крайне: крайне
маленький: мал
остальной: остального
защищать: защищает
армия: армия
мой: мо
взгляд: взгляд
стрелять: стрелять
спасибо: Спасибо
за: за
разжевать: разжевал
здоровый: здорово
уж: уж
теперь: Теперь
однако: Однако
выходить: выходит
размышлять: размышлял
интересный: интересные
няга: Нягу
изобретение: изобретения
мера: меру
рьяный: рьяный
лаборант: лаборант
фанат: фанат
местный: местных
вариант: вариантов
компьютерный: компьютерных
стрелялка: стрелялок
надо: надо
спросить: спросить
время: Время
провести: проведенное
обзорный: обзорной
палуба: палубе
пролететь: пролетело
незаметно: незаметно
молодой: Молодые
удовольствие: удовольствием
наблюдать: наблюдали
происходить: происходящим
снаружи: снаружи
при: при
норк: Норк
заправский: заправский
экскурсовод: экскурсовод
рассказывать: рассказывал
корабль: кораблях
попадать: попадающих
поле: поле
зрение: зрения
размер: размерах
тоннаж: тоннаже
количество: количестве
груз: груза
принимать: принимаемого
борт: борт
развивать: развиваемой
скорость: скорости
маневренность: маневренности
далее: далее
видно: Видно
благодарный: благодарного
слушатель: слушателя
неизвестный: Неизвестно
еще: ещ
там: там
проторчать: проторчали
парень: парни
б: б
почта: почту
прийти: пришло
сообщение: сообщение
энди: Энди
илюха: Илюха
ответить: ответил
связаться: связался
добраться: доберется
до: до
каюта: каюты
говорить: говорю
когда: когда
вокруг: вокруг
куча: куча
народ: народу
девушка: девушка
согласиться: согласилась
мол: мол
кожа: кожей
ощутить: ощутил
надуть: надула
губка: губки
вот: вот
пиво: Пива
тоже: тоже
опомниться: опомнился
оказываться: оказывается
закрытие: закрытия
вход: входа
территория: территорию
учебный: учебного
центр: центра
остаться: осталось
всего: всего
полчаса: полчаса
пора: пора
спешить: спешить
глава: Глава
добравшись: Добравшись
сразу: сразу
тут: тут
услышать: услышал
любимый: любимый
голос: голос
где: где
шляться: шлялся
гад: гад
успеть: успела
оставить: Оставьте
баба: бабы
кинуться: кинулся
какой: Какие
родный: родная
опешить: опешил
побояться: Побойся
бог: бога
дело: дела
станция: станцию
ходить: ходил
завтрато: Завтрато
уже: уже
выпустить: выпустят
дисциплина: дисциплина
военный: военная
увольнение: увольнения
строго: строго
регламентированные: регламентированные
ага: Ага
поэтому: поэтому
решить: решил
девка: девкам
пробежаться: пробежаться
солнце: солнце
девчонка: девчонок
сейчас: сейчас
прямо: прямо
потом: потом
ну: Ну
ерундато: ерундуто
придумывать: придумывать
скучать: скучаю
бестолочь: бестолочь
значить: значит
потвоему: потвоему
откуда: откуда
известный: известно
некогда: некогда
сильный: сильнее
любить: люблю
сильнее: сильнее
намного: намного
оченьочень: оченьочень
сильносильно: сильносильно
ладно: Ладно
засмеяться: засмеялась
считай: считай
прощеный: прощн
следующий: следующий
чтобы: чтобы
приготовить: приготовил
приятный: приятный
женский: женского
ухо: уха
договориться: Договорились
рыжее: рыжее
чудо: чудо
приятней: приятней
рад: рад
начинать: начинать
заааанять: заааанят
делааааам: делааааам
кстати: Кстати
хоть: хоть
делото: делато
рассказать: рассказал
внезапно: внезапно
появиться: появились
сказать: сказать
проблема: проблемы
помнить: Помню
придурок: придурков
сильно: сильно
возжелать: возжелавших
твой: твоего
роскошный: роскошного
тело: тела
скромный: скромных
сбережение: сбережений
конечно: конечно
славно: славно
повеселиться: повеселились
веселие: веселье
продолжиться: продолжится
один: одном
курс: курсе
восемь: восемь
сжато: сжато
произойти: произошедшем
столовая: столовой
инцидент: инциденте
поведать: поведал
плохой: плохо
расстроиться: расстроилась
оглядываться: оглядываться
постоянно: постоянно
прикрыть: прикрыть
некого: некому
понять: поняла
изза: изза
попереться: попрся
ничто: ничего
особенный: особенного
игольник: игольник
приобрести: приобрл
надеяться: надеешься
игла: игл
продать: продали
правильно: Правильно
хотя: хотя
урод: уроды
заслуживать: заслуживают
пучок: пучку
разрывных: разрывных
иголка: иголок
череп: череп
внимание: вниманию
похожий: похожие
отобрать: отобрали
схожий: схожую
название: названию
смысл: смысле
литература: литературу
надежда: надежде
предоставить: предоставить
читатель: читателей
больше: больше
обсуждение: Обсуждение
просто: просто
собственный: собственные
мнение: мнения
думать: думаете
главный: главных
указать: Укажите
конкретно: конкретно
понравиться: понравилось
почему: почему
считать: считаете
