заголовок: Заголовок
олег: Олег
данильченко: Данильченко
имперский: Имперский
вояж: вояж
читать: читать
онлайн: онлайн
бесплатно: бесплатно
адрес: Адрес
здесь: Здесь
быть: есть
возможность: Возможность
весь: всю
текст: текст
электронный: электронной
книга: книге
совершенно: совершенно
целиком: целиком
полный: полную
версия: версию
в: в
некоторый: некоторых
случай: случае
присутствовать: присутствует
краткий: краткое
содержание: содержание
город: Город
м: М
спб: СПб
год: год
выпуск: выпуска
издательство: издательство
аста: АСТ
издательский: Издательский
дом: дом
ленинград: Ленинград
категория: категорию
боевой: Боевая
фантастика: фантастика
космический: космический
на: на
русский: русском
язык: языке
описание: описание
произведение: произведении
предисловие: предисловие
а: а
так: так
же: же
отзыв: отзывы
посетитель: посетителей
доступный: доступны
портал: портале
библиотека: Библиотека
либ: Либ
кат: Кат
создать: создана
для: для
любитель: любителей
полистать: полистать
хороший: хорошую
книжка: книжку
и: и
предлагать: Предлагаем
широкий: широкий
выбор: выбора
жанр: жанров
любовный: любовные
роман: романы
фэнтези: фэнтези
приключение: приключения
детектив: детективы
триллер: триллеры
эротика: эротика
документальный: документальные
научный: научные
юмористический: юмористические
анекдот: анекдоты
о: о
бизнес: бизнесе
проза: проза
детский: детские
сказка: сказки
религиия: религиии
новинка: новинки
православный: православные
старинный: старинные
про: про
компьютер: компьютеры
программирование: программирование
английский: английском
домоводство: домоводство
поэзия: поэзия
выбрав: Выбрав
по: по
душа: души
вы: Вы
смочь: сможет
найти: нашли
действительно: действительно
стоить: стоящие
насладиться: насладиться
погружение: погружением
мир: мир
воображение: воображения
прочувствовать: прочувствовать
переживание: переживания
герой: героях
или: или
узнать: Узнайте
себя: себе
чтото: чемто
новый: новые
совершить: совершить
внутренний: внутреннее
открытие: открытие
подробный: Подробная
информация: информацию
ознакомление: ознакомления
текущий: текущему
запрос: запросу
представить: представлен
низкий: Ниже
к: к
чтение: чтение
аннотация: аннотацию
зависеть: зависит
от: от
тот: тех
что: что
написать: напишите
сам: сам
автор: автора
если: Если
не: не
необходимый: необходимую
комментарий: комментарии
мы: Мы
постараться: постараемся
отыскать: отыскать
она: она
кто: кто
фамилия: фамилию
как: как
звать: зовут
список: списком
его: его
серия: сериям
уважаемые: Уважаемые
правообладатель: правообладатели
размещать: размещать
наш: нашем
сайт: сайте
у: У
любой: любой
зарегистрировать: зарегистрированного
пользователь: пользователя
ваш: ваши
опубликовать: опубликована
без: без
согласие: согласия
пожалуйста: пожалуйста
направить: направьте
жалоба: жалобу
заполните: заполните
форма: формой
обратный: обратной
связь: связи
течение: течение
час: часа
закрыть: закроем
доступ: доступ
нелегально: нелегально
разместить: размещенному
контент: контенту
разбить: разбитый
страница: страницу
система: Система
сохранение: сохранения
место: места
последний: последней
прочитать: прочитанные
позволять: позволяет
с: С
удобство: удобством
необходимость: необходимости
каждый: каждый
раз: раз
заново: заново
искать: искать
остановиться: остановились
поставить: Поставьте
закладка: Закладка
момент: момент
перейти: перейти
который: которую
закончить: закончили
шрифт: Шрифт
интервал: Интервал
пока: пока
илья: Илье
такой: такого
своеобразный: своеобразным
образ: образом
признаваться: признавался
любовь: любви
наверное: наверное
уже: уже
миллионный: миллионный
за: за
пройти: прошедшие
два: две
неделя: неделя
эн: Эн
смотреть: смотрела
он: он
сверкающий: сверкающими
глаз: глаза
казаться: казалось
кричать: кричали
чтобы: чтобы
продолжать: Продолжал
это: это
делать: делать
говорить: говорить
свой: свой
они: они
стоять: стояли
обнявшись: обнявшись
обзорный: обзорной
палуба: палубе
дикарь: Дикарь
планета: планету
земля: Земле
огненноволосый: огненноволосая
девушка: девушка
звезда: звзд
корабль: корабле
величественно: величественно
плыть: плыл
поражающий: поражающей
размер: размером
станция: станцию
напоминать: напоминающей
арбуз: арбуз
из: из
вырезать: вырезали
ровно: ровно
четверть: четверть
только: только
очень: очень
уж: уж
большой: большой
арбузище: арбузище
получиться: получился
глава: Глава
после: После
швартовка: швартовки
начаться: началась
суета: суета
кудато: кудато
бежать: бежали
спешить: спешили
служба: службой
увольнение: увольнение
ктото: когото
отпуск: отпуск
вообще: вообще
вольная: вольные
хлеб: хлеба
окончание: окончанием
контракт: контракта
даже: Даже
атмосфера: атмосфера
накалиться: накалилась
но: но
впервой: впервой
проходить: проходил
еще: ещ
когда: когда
работать: работал
моторист: мотористом
ходить: ходил
море: море
видимо: Видимо
важный: важно
морской: морской
главный: главных
судно: судно
вернуться: вернулось
родной: родной
порт: порт
живойздоровый: живыздоровы
скоро: Скоро
увидеть: увидев
родные: родных
отдохнуть: Отдохнут
абордажный: абордажной
секция: секции
тоже: тоже
праздник: праздник
отдых: отдыха
охранный: охранная
поход: походе
возлагаться: возлагалась
их: их
плечо: плечи
теперь: Теперь
нестись: нестись
безопасность: безопасности
кстати: кстати
военный: военная
посторонний: посторонних
тут: тут
нет: нет
поэтому: Поэтому
вызвать: вызвал
грег: Грег
предупредить: предупредил
должный: должен
оставаться: оставаться
борт: борту
ни: ни
кой: коем
пытаться: пытаться
выйти: выйти
прогулка: прогулку
заодно: Заодно
проинформировать: проинформировал
день: день
уладить: уладит
организационный: организационные
вопрос: вопросы
связать: связанные
илюхин: Илюхиным
дело: дело
число: числе
открыть: открыть
счет: счт
имя: имя
скорый: скорее
завтра: завтра
отправиться: отправится
другой: другое
гражданский: гражданскую
орбитальный: орбитальным
лифт: лифтом
попасть: попасть
метрополия: Метрополии
естественно: Естественно
помочь: помогут
потеряться: потеряться
дать: Дадут
сопровождать: сопровождающего
проследить: проследит
эксцесс: эксцессов
добраться: добрался
до: до
эмиграционный: эмиграционного
центр: центра
сказать: Сказал
также: также
сопровождение: сопровождение
выбрать: выбрали
джойло: Джойл
энди: Энди
ну: Ну
бы: бы
мочь: мог
подумать: подумать
да: да
будто: будто
спрашивать: спрашивала
прийтись: Пришлось
собираться: собираться
верный: Вернее
собирать: собирать
емуто: Емуто
голый: Голому
одеться: одеться
говориться: говорится
вот: вот
вылезти: вылезли
орбита: орбит
случайно: случайно
зайти: зашл
каюта: каюту
где: где
три: три
кряду: кряду
наблюдать: наблюдал
удивительный: удивительное
зрелище: зрелище
волшебный: Волшебным
укромный: укромных
уголок: уголков
принцип: принципе
небольшой: небольшого
помещение: помещения
появляться: появлялись
какойто: какойто
чемоданчик: чемоданчики
сумка: сумки
пакет: пакеты
безразмерный: безразмерных
недра: недр
несмотря: несмотря
внешний: внешний
вид: вида
извлекаться: извлекались
разный: разного
фасон: фасона
платье: платья
брюки: брюки
майка: майки
шорты: шорты
слово: слова
закончиться: закончились
тряпка: тряпок
разнокалиберный: разнокалиберные
кровать: кровать
лежать: лежала
внушительный: внушительная
гора: гора
можно: можно
одеть: одеть
женский: женское
население: население
земной: земного
провинциальный: провинциального
городок: городка
примеряться: примерялось
спрашиваться: спрашивалось
мнение: мнения
через: через
мгновение: мгновение
успевать: успевал
рот: рот
сниматься: снималось
надеваться: надевалось
касаться: касалось
нижний: нижнего
белье: белья
больше: больше
чем: чем
остальной: остального
этот: эту
вакханалия: вакханалию
сначала: сначала
сочувственно: сочувственно
посмотреть: посмотрел
илюха: Илюху
потом: потом
ехидненько: ехидненько
усмехнувшись: усмехнувшись
малодушно: малодушно
слинять: слинял
оставить: Оставьте
один: одну
отдуваться: отдуваться
признаться: признаться
нравиться: нравилось
какой: Какой
мужчина: мужчина
устоять: устоит
красивый: красивых
женщина: женщина
примерять: примеряет
наряд: наряды
то: то
одеваться: одеваясь
полностью: полностью
раздеваться: раздеваясь
донага: донага
несколько: несколько
выдерживать: выдерживал
смех: смехом
хватать: хватал
охапка: охапку
увлекать: увлекая
прямо: прямо
куча: кучу
набросать: набросанных
туда: туда
притворный: притворно
визжать: визжала
сопротивляться: сопротивлялась
обычно: обычно
недолго: недолго
все: вс
повторяться: повторялось
снова: снова
умиротворенно: умиротворенно
взирать: взирал
думать: думаете
господь: Господи
всемогущий: всемогущий
откуда: откуда
доставать: достает
заталкивать: заталкивать
обратно: обратно
хотя: Хотя
баба: бабы
неважный: неважно
следующий: следующий
наконец: наконец
прийти: пришло
время: время
отправляться: отправляться
переходный: переходного
шлюз: шлюза
встретить: встретил
передать: передал
банковский: банковскую
карта: карту
логотип: логотипом
центральный: центрального
банк: банка
империя: Империи
мало: мало
отличаться: отличалась
приходиться: приходилось
видеть: видеть
разве: Разве
напоследок: Напоследок
шепнуть: шепнул
получить: получить
лоялитипоинт: лоялитипоинт
сразу: сразу
перевести: переведт
оговорить: оговоренную
сумма: сумму
посоветовать: посоветовал
получение: получения
гражданство: гражданство
тянуть: тянуть
идти: идти
устанавливать: устанавливать
нейросеть: нейросеть
подмигнуть: подмигнул
добавить: добавил
молодец: Молодец
илио: Илио
успеть: успел
заполучить: заполучил
самый: самых
гражданка: гражданок
оттянуться: Оттянись
там: там
катушка: катушку
заслужить: заслужила
представлять: Представляем
внимание: вниманию
похожий: похожие
отобрать: отобрали
схожий: схожую
название: названию
смысл: смысле
литература: литературу
надежда: надежде
предоставить: предоставить
читатель: читателей
вариант: вариантов
интересный: интересные
обсуждение: Обсуждение
просто: просто
собственный: собственные
указать: Укажите
конкретно: конкретно
понравиться: понравилось
почему: почему
считать: считаете
