заголовок: Заголовок
олег: Олег
данильченко: Данильченко
имперский: Имперский
вояж: вояж
читать: читать
онлайн: онлайн
бесплатно: бесплатно
адрес: Адрес
здесь: Здесь
быть: будет
возможность: Возможность
весь: всех
текст: текст
электронный: электронной
книга: книге
совершенно: совершенно
целиком: целиком
полный: полную
версия: версию
в: в
некоторый: некоторых
случай: случае
присутствовать: присутствует
краткий: краткое
содержание: содержание
город: Город
м: М
спб: СПб
год: год
выпуск: выпуска
издательство: издательство
аста: АСТ
издательский: Издательский
дом: дом
ленинград: Ленинград
категория: категорию
боевой: боевых
фантастика: фантастика
космический: Космическая
на: на
русский: русском
язык: языке
описание: описание
произведение: произведении
предисловие: предисловие
а: а
так: так
же: же
отзыв: отзывы
посетитель: посетителей
доступный: доступны
портал: портале
библиотека: Библиотека
либ: Либ
кат: Кат
создать: создана
для: для
любитель: любителей
полистать: полистать
хороший: хорошую
книжка: книжку
и: и
предлагать: Предлагаем
широкий: широкий
выбор: выбора
жанр: жанров
любовный: любовные
роман: романы
фэнтези: фэнтези
приключение: приключения
детектив: детективы
триллер: триллеры
эротика: эротика
документальный: документальные
научный: научные
юмористический: юмористические
анекдот: анекдоты
о: о
бизнес: бизнесе
проза: проза
детский: детские
сказка: сказки
религиия: религиии
новинка: новинки
православный: православные
старинный: старинные
про: про
компьютер: компьютеры
программирование: программирование
английский: английском
домоводство: домоводство
поэзия: поэзия
выбрав: Выбрав
по: по
душа: душе
вы: Вы
смочь: сможем
найти: нашли
действительно: действительно
стоить: стоящие
насладиться: насладиться
погружение: погружением
мир: мир
воображение: воображения
прочувствовать: прочувствовать
переживание: переживания
герой: героях
или: или
узнать: Узнайте
себя: себя
чтото: чтото
новый: новые
совершить: совершить
внутренний: внутреннее
открытие: открытие
подробный: Подробная
информация: информацию
ознакомление: ознакомления
текущий: текущему
запрос: запросу
представить: представлен
низкий: Ниже
к: к
чтение: чтение
аннотация: аннотацию
зависеть: зависит
от: от
тот: тем
что: что
написать: напишите
сам: самом
автор: автора
если: Если
не: не
необходимый: необходимую
комментарий: комментарии
мы: Мы
постараться: постараемся
отыскать: отыскать
она: ей
кто: кто
фамилия: фамилию
как: как
звать: зовут
список: списком
его: его
серия: сериям
уважаемые: Уважаемые
правообладатель: правообладатели
размещать: размещать
наш: нашем
сайт: сайте
у: У
любой: любом
зарегистрировать: зарегистрированного
пользователь: пользователя
ваш: ваши
опубликовать: опубликована
без: без
согласие: согласия
пожалуйста: пожалуйста
направить: направьте
жалоба: жалобу
заполните: заполните
форма: форму
обратный: обратной
связь: связи
течение: течение
час: часов
закрыть: закроем
доступ: доступ
нелегально: нелегально
разместить: размещенному
контент: контенту
разбить: разбитый
страница: страницу
система: Система
сохранение: сохранения
место: места
последний: последней
прочитать: прочитанные
позволять: позволяет
с: с
удобство: удобством
необходимость: необходимости
каждый: каждый
раз: раз
заново: заново
искать: искать
остановиться: остановились
поставить: Поставьте
закладка: Закладка
момент: момент
перейти: перейти
который: которой
закончить: закончили
шрифт: Шрифт
интервал: Интервал
беррана: Беррана
ну: Ну
дело: деле
ты: ты
пристать: пристала
человек: люди
вступиться: вступилась
за: за
илья: Илья
милла: Милла
рилла: Рилла
он: он
тут: тут
рассказывать: рассказывает
мочь: может
сначала: сначала
дать: даст
сказать: скажешь
насупиться: насупилась
я: я
продолжать: продолжала
спросить: спросил
илюха: Илюха
близняшка: близняшкам
часто: часто
закивать: закивали
вот: вот
сократить: сократить
отставание: отставание
но: но
зато: зато
взять: взять
качество: качеством
думать: думаете
да: да
там: там
почти: почти
уверенный: уверен
большинство: большинство
особенно: особенно
такой: такой
балбес: балбесы
пил: Пиле
жополиза: жополизы
спешить: спешить
пропускать: пропускать
изучение: изучение
второстепенный: второстепенных
навык: навыки
чтобы: чтобы
быстрый: быстрее
добраться: добермся
до: до
более: более
серьезный: серьзных
изучать: изучать
тихо: тихо
поднять: Поднял
рука: рук
успокаивать: успокаивающем
жест: жесте
видеть: видя
собираться: собирается
опять: опять
ляпнуть: ляпнуть
язвительный: язвительное
знать: знать
еще: ещ
большой: больше
отстать: отстанем
первый: первых
пора: пора
это: это
важный: важно
второй: второй
этап: этапом
никто: никто
управлять: управлять
ни: ни
линкор: линкором
дредноут: дредноутом
даже: даже
виртуальный: виртуальном
тренажер: тренажре
верно: верно
легкий: Лгкие
крейсер: крейсера
стать: стал
третий: третьим
исключительно: исключительно
иметь: имеет
самый: самые
мощный: мощные
нейросеть: нейросети
только: только
они: они
успеть: успеть
подтянуть: подтянуть
время: время
свой: своей
соответствующий: соответствующего
уровень: уровня
остальной: Остальным
прийтись: Пришлось
довольствоваться: довольствоваться
простой: простыми
фрегат: фрегатов
этот: эту
какой: какие
разница: разница
выучить: выучить
ли: ли
вооружение: вооружение
нет: нет
пушка: Пушки
равный: равно
встать: встанут
уже: уже
нос: нос
утереть: утереть
касаться: касается
максимум: максимуму
подсчитать: подсчитал
точно: точно
база: Базы
знание: знаний
малый: малым
корабль: корабли
учиться: учатся
втрое: втрое
чем: чем
например: например
крупнотоннажный: крупнотоннажные
говорить: говорить
под: Под
разгон: разгоном
должный: должны
при: при
остаться: останется
рукопашка: рукопашке
пехотный: пехотном
бой: бою
отчегото: отчегото
забить: забьм
общераспространенный: общераспространенному
мнение: мнения
пилот: пилоты
воевать: воюют
строй: строю
дисциплина: дисциплине
тоже: тоже
начистить: начистим
рыло: рыло
выскочка: выскочкам
предупреждать: предупреждаю
работать: работать
плотно: плотно
мой: мои
мысль: мысли
заметить: заметил
мера: мере
разжевывать: разжвывал
лицо: лицах
товарищ: товарищей
начинать: начинали
появляться: появляться
понимать: понимающие
улыбка: улыбки
скептически: скептически
хмуриться: хмуриться
однако: однако
похоже: похоже
понять: поняла
идея: идею
нравиться: нравится
заявить: заявил
норк: Норк
согласный: Согласна
план: план
вполне: Вполне
реально: реально
провернуть: провернуть
захлопали: Захлопали
ладоши: ладоши
блондинка: блондинки
бер: Бер
хотеть: хочу
услышать: услышать
вообще: вообще
разрешать: разрешала
обращаться: обращаться
образ: образом
близкий: близкие
твой: твой
таки: таки
договориться: договорились
действовать: действовать
сообща: сообща
то: то
бы: бы
разрешить: разрешить
обращение: обращения
друг: друга
упрощенный: упрощнном
вариант: вариантов
нужный: нужно
очевидно: очевидно
относительно: относительно
два: два
логичный: логичен
вынудить: вынуждена
признать: признать
ведь: Ведь
рано: рано
поздно: поздно
тогда: тогда
приказать: прикажешь
делать: делать
безнадежно: безнаджно
вряд: вряд
выправить: выправить
хитрый: хитрыми
трюк: трюками
счет: счт
пока: пока
смутный: смутные
надо: Надо
прожить: прожить
вылететь: вылететь
ворота: ворота
прийти: Придт
разобраться: разберемся
четвертый: четвертым
пятый: пятый
покорить: покорим
держаться: держался
дома: дома
поговорка: поговорка
один: одного
передавать: передает
смысл: смысле
задумать: задуманного
команда: команда
протянуть: протянула
серьезно: Серьезно
кивнуть: кивнул
унисон: унисон
пискнули: пискнули
блонда: блонды
протягивать: протягивая
розовый: розовые
ладошка: ладошки
ладно: Ладно
убедить: убедил
впервые: Впервые
открыто: открыто
улыбнуться: улыбнулся
берран: Беррана
соединить: соединил
пять: пять
накрыть: накрыв
сверху: сверху
похожий: похожие
надрать: Надерм
булка: булки
хор: хором
прозвучать: прозвучало
ответ: ответ
теперь: теперь
всетаки: встаки
поесть: поедим
сейчас: сейчас
помереть: помру
голод: голода
глава: Глава
потянуться: Потянулись
учебный: учебного
будни: будни
неделя: неделю
пролететь: пролетела
незаметно: незаметно
установить: установил
плотный: плотный
график: график
ребята: ребята
вылезать: вылезали
из: из
капсула: капсул
выжать: выжатые
лимон: лимон
больше: больше
доставаться: доставалось
после: После
день: дня
смотреть: смотреть
больно: больно
бледный: бледные
красный: красными
глаз: глазами
едва: едва
хватать: хватало
сила: сил
доползти: доползти
столовая: столовой
както: Както
попытаться: попытались
завалиться: завалиться
спать: спать
натощак: натощак
мотивировать: мотивируя
мол: мол
устать: устали
хотеться: хочется
жестко: жстко
пресечь: преск
риго: Риго
нормально: нормально
настолько: настолько
упрямый: упряма
коврижка: коврижки
показать: показала
слабость: слабости
хотя: хотя
видно: видно
очень: очень
трудный: трудно
приходиться: приходится
начало: начало
порах: порах
тяжело: тяжело
даваться: датся
потом: потом
какойто: какойто
землянин: землянин
начать: начал
сомневаться: сомневаться
верность: верности
выбрать: выбрали
стратегия: стратегии
загнать: загнав
червячок: червячка
сомнение: сомнений
поглубже: поглубже
ничто: ничего
менять: менять
решить: решит
придерживаться: придерживаться
линия: линии
обучение: обучения
полностью: полностью
лимит: лимит
разгонный: разгонным
препарат: препаратам
тема: тему
пытаться: пыталась
скандалить: скандалить
справедливо: справедливо
обвинять: обвиняя
нерациональный: нерациональном
использование: использовании
оный: оных
объяснять: объяснять
проблема: проблему
давно: давно
поговорить: поговорить
няга: Нягу
висеть: висел
должок: должок
представлять: Представляем
внимание: вниманию
отобрать: отобрали
схожий: схожую
название: названию
литература: литературу
надежда: надежде
предоставить: предоставить
читатель: читателей
интересный: интересные
обсуждение: Обсуждение
просто: просто
собственный: собственные
оставить: Оставьте
главный: главных
указать: Укажите
конкретно: конкретно
понравиться: понравилось
почему: почему
считать: считаете
