заголовок: Заголовок
олег: Олег
данильченко: Данильченко
имперский: Имперский
вояж: вояж
читать: читать
онлайн: онлайн
бесплатно: бесплатно
адрес: Адрес
здесь: здесь
быть: будет
возможность: возможность
весь: весь
текст: текст
электронный: электронной
книга: книге
совершенно: совершенно
целиком: целиком
полный: полную
версия: версию
в: в
некоторый: некоторых
случай: случае
присутствовать: присутствует
краткий: краткое
содержание: содержание
город: Город
м: М
спб: СПб
год: год
выпуск: выпуска
издательство: издательство
аста: АСТ
издательский: Издательский
дом: дом
ленинград: Ленинград
категория: категории
боевой: Боевая
фантастика: фантастика
космический: Космическая
на: на
русский: русском
язык: языке
описание: описание
произведение: произведении
предисловие: предисловие
а: а
так: так
же: же
отзыв: отзывы
посетитель: посетителей
доступный: доступны
портал: портале
библиотека: Библиотека
либ: Либ
кат: Кат
создать: создана
для: для
любитель: любителей
полистать: полистать
хороший: лучшими
книжка: книжку
и: и
предлагать: Предлагаем
широкий: широкий
выбор: выбора
жанр: жанров
любовный: любовные
роман: романы
фэнтези: фэнтези
приключение: приключения
детектив: детективы
триллер: триллеры
эротика: эротика
документальный: документальные
научный: научные
юмористический: юмористические
анекдот: анекдоты
о: о
бизнес: бизнесе
проза: проза
детский: детские
сказка: сказки
религиия: религиии
новинка: новинки
православный: православные
старинный: старинные
про: про
компьютер: компьютеры
программирование: программирование
английский: английском
домоводство: домоводство
поэзия: поэзия
выбрав: Выбрав
по: по
душа: душе
вы: Вы
смочь: сможешь
найти: нашли
действительно: действительно
стоить: стоит
насладиться: насладиться
погружение: погружением
мир: мир
воображение: воображения
прочувствовать: прочувствовать
переживание: переживания
герой: героях
или: или
узнать: Узнайте
себя: себе
чтото: чтото
новый: новые
совершить: совершить
внутренний: внутреннее
открытие: открытие
подробный: Подробная
информация: информацией
ознакомление: ознакомления
текущий: текущему
запрос: запросу
представить: представлен
низкий: Ниже
к: к
чтение: чтение
аннотация: аннотацию
зависеть: зависит
от: от
тот: Тем
что: что
написать: напишите
сам: сам
автор: автора
если: если
не: не
необходимый: необходимую
комментарий: комментарии
мы: Мы
постараться: постараемся
отыскать: отыскать
она: ней
кто: кто
фамилия: фамилию
как: как
звать: зовут
список: списком
его: его
серия: сериям
уважаемые: Уважаемые
правообладатель: правообладатели
размещать: размещать
наш: наши
сайт: сайте
у: у
любой: любые
зарегистрировать: зарегистрированного
пользователь: пользователя
ваш: ваши
опубликовать: опубликована
без: без
согласие: согласия
пожалуйста: пожалуйста
направить: направьте
жалоба: жалобу
заполните: заполните
форма: форму
обратный: обратной
связь: связи
течение: течение
час: часов
закрыть: закроем
доступ: доступ
нелегально: нелегально
разместить: размещенному
контент: контенту
разбить: разбитый
страница: страницу
система: системой
сохранение: сохранения
место: места
последний: последний
прочитать: прочитанные
позволять: позволяет
с: С
удобство: удобством
необходимость: необходимости
каждый: каждый
раз: раз
заново: заново
искать: искать
остановиться: остановились
поставить: поставили
закладка: Закладка
момент: момент
перейти: перейти
который: которую
закончить: закончили
шрифт: Шрифт
интервал: Интервал
спасибо: Спасибо
господин: господин
бал: Балах
сказать: сказать
я: я
правильно: правильно
понять: понял
достаться: достались
курсант: курсант
дешевый: дешвыми
нейросеть: нейросеть
точно: точно
высокий: высокими
показатель: показателями
фпи: ФПИ
сетка: сетками
отобрать: отобрали
мой: мои
коллега: коллеги
подтвердить: подтвердил
догадка: догадку
илья: Илья
наставник: наставник
соревнование: соревнований
тогда: тогда
ведь: Ведь
логика: логике
вещь: вещей
отставать: отставать
скорость: скорости
обучение: обучение
получаться: Получается
несправедливый: несправедливо
обещать: обещал
справедливость: справедливость
привыкайте: Привыкайте
но: но
даже: даже
группа: группа
неполный: неполная
получиться: получилась
один: одного
хватать: хватает
это: это
никой: никоим
образ: образом
должный: должен
лично: лично
помешать: помешать
постигать: постигать
наука: науку
прийти: пришли
сюда: сюда
учиться: учиться
вот: Вот
давать: давайте
забудьте: забудьте
нет: нет
всякий: всяком
этот: этих
зверь: зверь
давно: давно
встречаться: встречался
еще: ещ
вопрос: вопрос
да: да
илюха: Илюхе
немного: немного
помяться: помялся
решать: решая
ли: ли
вообще: вообще
задавать: задавать
решиться: решился
когда: когда
капитан: капитаном
представлять: Представляем
создаться: создалось
впечатление: впечатление
он: него
делать: делал
пытаться: пытаясь
обидеть: обидеть
показаться: показалось
маска: Маска
скучающий: скучающей
усталость: усталости
слететь: слетела
балах: Балаха
заиграли: Заиграли
желваки: желваки
скула: скулах
какойто: Какоето
время: время
молчать: молчите
разглядывать: разглядывая
землянин: землянин
подумать: подумал
ответ: ответ
последовать: последовал
ошибиться: ошибся
наблюдательный: наблюдательны
лео: Лео
однако: Однако
отношение: отношения
касаться: касаются
уметь: умеете
смотреть: смотреть
замечать: замечать
очень: очень
хорошо: хорошо
весьма: весьма
пригодиться: пригодится
будущее: будущем
пилот: пилота
добавить: Добавлю
только: только
кроме: кроме
прочий: прочего
также: также
выбирать: выбирать
противник: противника
сила: силы
сегодня: сегодня
заиметь: заимели
личный: личного
враг: врага
при: при
абсолютно: абсолютно
весовой: весовой
далекий: дальше
пойти: пойдет
трудный: трудно
видеть: видите
наблюдать: наблюдать
смутиться: смутился
оказываться: Оказывается
вид: виду
флегматичный: флегматичный
пенсионер: пенсионер
простой: прост
казаться: кажется
первый: Первый
взгляд: взгляд
ну: Ну
нарушить: нарушил
затянуться: затянувшуюся
пауза: паузу
нечего: нечего
почему: почему
думать: думаете
теперь: теперь
улыбнуться: улыбнулся
слышать: слышу
правильный: правильные
слово: слова
держать: Держите
свой: своей
мысль: мысли
проще: проще
флаглейтенант: флаглейтенант
хотеться: хотелось
бы: бы
увольнительные: увольнительные
получать: получать
заведомо: заведомо
такой: Таким
условие: условия
практически: практически
невозможный: невозможно
уверенный: уверен
учитывать: учитывая
сеть: сети
легко: легко
удаться: удастся
обогнать: обогнать
светить: светить
эн: Эн
ди: Ди
видеться: видеться
уже: уже
говорить: говорил
повторить: повторю
чтобы: чтобы
потратьте: Потратьте
польза: пользой
задача: задача
вынести: вынести
из: из
стена: стен
максимальный: максимальное
количество: количество
знание: знания
заканчивать: Заканчивая
разговор: разговорами
дать: даст
совет: совет
искусство: искусстве
упираться: упирается
качество: качество
поверить: поверьте
трудолюбие: Трудолюбие
совокупность: совокупности
креативный: креативным
нестандартный: нестандартным
мышление: мышлением
значить: значат
меньше: меньше
иногда: иногда
гораздо: гораздо
больше: больше
надо: Надо
стараться: стараться
подытожить: подытожил
подмигнуть: подмигнул
веселый: Весело
подмигнул: подмигнул
за: за
забыть: забытой
главный: главных
мочь: могу
освоиться: освоиться
капсула: капсуле
получить: получить
база: баз
считать: считаете
учеба: учеба
начаться: началась
приступайте: Приступайте
ах: Ах
совсем: совсем
ктото: комуто
понадобиться: понадобятся
профиль: профилю
заказать: закажи
они: они
через: через
прямо: прямо
предоставить: предоставить
немедленно: немедленно
просить: прошу
соизмерять: соизмеряйте
жадность: жадность
угнездившись: Угнездившись
тут: тут
услышать: услышал
начинать: Начинаю
принимать: Принимаю
прекрасно: Прекрасно
ты: ты
пропасть: Пропал
спорный: спорный
технический: технических
босс: босс
несколько: несколько
обиженный: обиженный
два: двумя
поток: потоками
ставить: ставить
приоритет: приоритет
изучение: изучения
профильный: профильных
основный: основным
профессия: профессии
рекомендовать: рекомендую
изучать: изучать
сон: сне
приостанавливать: приостанавливая
под: под
разгон: разгоном
нагонять: нагонять
отставание: отставание
оба: обе
специальность: специальности
одновременно: одновременно
поступим: поступим
согласиться: согласился
уровень: уровень
загрузить: загружены
можно: можно
смысл: смысле
сейчас: сейчас
использовать: использовать
никакой: Никакого
изучить: изучим
другой: другие
занять: займет
шесть: шесть
прийтись: придтся
выбираться: выбираться
отсюда: отсюда
второй: вторые
третий: третий
ускорить: ускорим
коктейль: коктейлем
остаться: останется
подтянуть: подтянуть
рассчитать: рассчитала
засветиться: засветимся
подтягивать: подтягивать
непрофильный: непрофильные
более: более
сократить: сократить
адаптировать: адаптируя
иметься: имеющиеся
навык: навыки
применять: применяемые
какойникакой: какойникакой
прирост: прирост
особенно: особенно
касательно: касательно
твой: твой
земной: земные
мало: мало
отличаться: отличаются
местный: местных
план: плане
математика: математики
физика: физики
геометрия: геометрии
механика: механики
химия: химии
плохой: Плохо
блистать: блещут
обширность: обширностью
плюс: плюс
хоть: хоть
чутьчуть: чутьчуть
сэкономить: сэкономим
позволение: позволения
систематизировать: систематизировать
опыт: опыт
похожий: похожие
дефрагментация: дефрагментацию
пользоваться: пользоваться
сохранить: сохраненной
память: памяти
внимание: вниманию
схожий: схожую
название: названию
литература: литературу
надежда: надежде
читатель: читателей
вариант: вариантов
интересный: интересные
обсуждение: Обсуждение
просто: просто
собственный: собственные
мнение: мнения
оставить: Оставьте
указать: Укажите
конкретно: конкретно
понравиться: понравилось
