заголовок: Заголовок
олег: Олег
данильченко: Данильченко
имперский: Имперский
вояж: вояж
читать: читать
онлайн: онлайн
бесплатно: бесплатно
адрес: Адрес
здесь: Здесь
быть: будет
возможность: Возможность
весь: вс
текст: текст
электронный: электронной
книга: книге
совершенно: совершенно
целиком: целиком
полный: полную
версия: версию
в: в
некоторый: некоторых
случай: случае
присутствовать: присутствует
краткий: краткое
содержание: содержание
город: Город
м: М
спб: СПб
год: год
выпуск: выпуска
издательство: издательство
аста: АСТ
издательский: Издательский
дом: дом
ленинград: Ленинград
категория: категорию
боевой: Боевая
фантастика: фантастика
космический: Космическая
на: на
русский: русском
язык: языке
описание: описание
произведение: произведении
предисловие: предисловие
а: а
так: так
же: же
отзыв: отзывы
посетитель: посетителей
доступный: доступны
портал: портале
библиотека: Библиотека
либ: Либ
кат: Кат
создать: создана
для: для
любитель: любителей
полистать: полистать
хороший: хорошая
книжка: книжку
и: и
предлагать: Предлагаем
широкий: широкий
выбор: выбора
жанр: жанров
любовный: любовные
роман: романы
фэнтези: фэнтези
приключение: приключения
детектив: детективы
триллер: триллеры
эротика: эротика
документальный: документальные
научный: научные
юмористический: юмористические
анекдот: анекдоты
о: о
бизнес: бизнесе
проза: проза
детский: детские
сказка: сказки
религиия: религиии
новинка: новинки
православный: православные
старинный: старинные
про: про
компьютер: компьютеры
программирование: программирование
английский: английском
домоводство: домоводство
поэзия: поэзия
выбрав: Выбрав
по: по
душа: душе
вы: Вы
смочь: сможете
найти: нашли
действительно: действительно
стоить: стоящие
насладиться: насладиться
погружение: погружением
мир: миру
воображение: воображения
прочувствовать: прочувствовать
переживание: переживания
герой: героях
или: или
узнать: Узнайте
себя: себя
чтото: чтото
новый: новые
совершить: совершить
внутренний: внутреннее
открытие: открытие
подробный: Подробная
информация: информацию
ознакомление: ознакомления
текущий: текущему
запрос: запросу
представить: представлен
низкий: Ниже
к: К
чтение: чтение
аннотация: аннотацию
зависеть: зависит
от: от
тот: То
что: что
написать: напишите
сам: сам
автор: автора
если: если
не: не
необходимый: необходимых
комментарий: комментарии
мы: Мы
постараться: постараемся
отыскать: отыскать
она: ней
кто: кто
фамилия: фамилию
как: как
звать: зовут
список: списком
его: его
серия: сериям
уважаемые: Уважаемые
правообладатель: правообладатели
размещать: размещать
наш: нашем
сайт: сайте
у: у
любой: любого
зарегистрировать: зарегистрированного
пользователь: пользователя
ваш: ваши
опубликовать: опубликована
без: без
согласие: согласия
пожалуйста: пожалуйста
направить: направьте
жалоба: жалобу
заполните: заполните
форма: форму
обратный: обратной
связь: связи
течение: течение
час: часов
закрыть: закроем
доступ: доступ
нелегально: нелегально
разместить: размещенному
контент: контенту
разбить: разбитый
страница: страницу
система: систем
сохранение: сохранения
место: места
последний: последней
прочитать: прочитанные
позволять: позволяет
с: С
удобство: удобством
необходимость: необходимости
каждый: каждый
раз: раз
заново: заново
искать: искать
остановиться: остановились
поставить: Поставьте
закладка: Закладка
момент: момент
перейти: перейти
который: которых
закончить: закончили
шрифт: Шрифт
интервал: Интервал
такой: такие
тюнингмодуль: тюнингмодулей
это: это
всевозможный: всевозможные
модуль: модули
улучшение: улучшения
иной: иных
штатный: штатные
характеристика: характеристикам
корабль: корабли
сколько: Сколько
существовать: Существуют
ровный: ровным
счет: счтом
столько: столько
иметься: Имеется
пример: примера
взять: взятый
маршевый: маршевый
двигатель: двигатель
он: он
выдавать: выдает
нагор: нагора
какойто: какоето
определенный: определенное
количество: количества
тяга: тяги
вдаваться: вдаваться
математика: математику
цифра: цифрами
земной: земных
аналог: аналогов
равный: равным
сравнить: сравнить
вот: Вот
установить: установить
под: под
название: названию
улучшить: улучшенная
форсажный: форсажная
камера: камера
уфк: УФК
то: то
двигнуть: двигло
форсаж: форсаже
естественно: естественно
вчетверо: вчетверо
перекрыть: перекроет
кратковременный: кратковременно
иначе: иначе
можно: можно
спалить: спалить
игрушка: игрушка
дорогой: дорог
да: да
только: только
жизнь: жизнь
всяк: всяко
ладно: Ладно
принцип: принципе
действие: действия
перетерли: перетрли
отдельно: отдельно
обсасывать: обсасывать
идти: идт
далекий: дальше
теперь: Теперь
кораблик: корабликах
целое: целом
начать: начнем
пожалуй: пожалуй
военный: военных
флот: флот
проще: проще
сразу: Сразу
оговориться: оговоримся
разный: разных
раса: рас
они: них
отличаться: отличаются
основный: основным
размер: размера
дизайн: дизайном
свой: своим
усреднить: усредненным
сопоставимый: сопоставимы
итак: Итак
делиться: Делятся
несколько: несколько
класс: класс
самый: Самые
больший: большего
дредноут: дредноут
медленный: медленные
огромный: огромные
до: до
км: км
длина: длину
неимоверный: неимоверным
огневой: огневая
мощь: мощь
жутко: жутко
защитить: защищнные
речь: речь
перестрелка: перестрелке
противник: противника
однако: Однако
одиночка: одиночку
против: против
мелкий: мелких
но: Но
зубастый: зубастых
цель: цели
беспомощный: беспомощные
использоваться: используется
исключительно: исключительно
состав: составе
эскадра: эскадр
когда: когда
надо: Надо
прорвать: прорвать
орбитальный: орбитальную
оборона: оборону
точно: точно
монстр: монстра
дальний: дальнего
поход: походы
ходить: ходят
редко: редко
топливо: топлива
жрать: жрут
бык: бык
помои: помои
подкласс: подклассов
практически: практически
строиться: строится
ибо: ибо
дорого: дорого
значить: значит
нефиг: нефиг
поэтому: поэтому
модернизироваться: модернизируются
старый: старые
образец: образцами
изначально: изначально
закладываться: закладывалось
конструкция: конструкцию
далее: Далее
следовать: следуют
значительно: значительно
малый: малых
линкор: линкоры
эдакий: Эдакий
суррогат: суррогат
серьезный: серьезных
конфликт: конфликтах
гнать: гнать
очень: очень
накладно: накладно
нужный: нужна
дозарез: дозарезу
паратроек: Паратройка
вполне: вполне
мочь: может
сравняться: сравняться
старший: старшим
брат: братом
совокупный: совокупной
мощность: мощности
залп: залпа
этот: эти
тип: тип
производство: производстве
обстоятельство: обстоятельством
наряду: наряду
четыре: четырех
субъект: субъектов
содружество: Содружестве
сей: сей
день: день
вооружение: вооружении
стоять: стоят
уже: уже
порядок: порядку
устареть: устаревшие
отметить: отметить
никогда: никогда
списываться: списываются
свободный: свободную
продажа: продажу
нести: несут
служба: службе
конец: конца
вид: виду
повредить: поврежден
бой: боя
настолько: настолько
ремонт: ремонт
встать: встанет
дороже: дороже
постройка: постройки
переработка: переработку
из: из
переработать: переработанного
сырье: сырья
выходить: выходит
дешевый: дешевле
купить: купит
громадина: громадину
даже: Даже
богатый: богатейшие
корпорация: корпорации
позволить: позволит
содержа: Содержа
немудрено: немудрено
пойти: пойти
продолжать: Продолжаем
знакомиться: знакомиться
линейный: линейного
крейсер: Крейсера
воистину: воистину
акула: акулы
космос: космоса
быстрый: Быстрые
автономный: автономные
впечатляющий: впечатляющей
защита: Защита
являться: являются
составлять: составляющими
стая: Стая
легко: легко
сожрать: сожрт
говорить: говоря
нечего: нечего
применение: Применение
их: их
многогранно: многогранно
гибко: гибко
прекрасно: прекрасно
чувствовать: чувствуют
собраться: соберутся
большой: большой
после: после
нашествие: нашествия
саранча: саранчи
ничто: ничего
живой: живого
оставаться: остатся
два: два
впрочем: впрочем
оба: оба
мало: мало
друг: друга
главный: главных
скорость: скорость
защищенность: защищнность
разница: разница
минимальный: минимальна
заслуживать: заслуживает
внимание: вниманию
менее: менее
распространить: распространенный
чем: чем
предыдущий: предыдущий
причина: причине
особый: особой
зубастость: зубастости
хотя: хотя
поддержка: поддержки
обеспечение: обеспечения
установщик: установщики
минный: минные
заграждение: заграждений
совместительство: совместительству
тральщик: тральщики
рэб: РЭБ
радиоэлектронный: радиоэлектронной
борьба: борьбы
собственно: собственно
зубастик: зубастики
рассмотреть: Рассмотрим
время: время
обеспечивать: обеспечивают
энергетический: энергетическую
подпитка: подпитку
знать: знают
способ: способом
передача: передачи
энергия: энергии
расстояние: расстоянии
беспроводный: беспроводным
дистанционный: дистанционную
накачка: накачку
силовой: силового
щит: щита
также: также
зенитный: зенитную
прикрытие: прикрытие
слабый: слабая
участвовать: участвуют
постольку: постольку
поскольку: поскольку
особо: особо
нуждаться: нуждаются
всегда: всегда
быстро: быстро
слинять: слинять
ремонтник: ремонтники
первый: первые
заниматься: занимаются
помогать: помогают
воевать: воевать
участник: участникам
подобный: подобных
шоу: шоу
прямо: прямо
производить: производят
посильный: посильный
иметь: Имеют
порядочный: порядочную
вместимость: вместимость
трюм: трюма
складирование: складирования
запасный: запасных
часть: частей
при: При
возникновение: возникновении
нужда: нужды
встраиваться: встраиваться
общий: общую
сеть: сеть
броня: броней
относительно: относительно
чуткий: чутка
маленький: поменьше
делать: делают
нога: ноги
правило: правило
гораздо: гораздо
ранний: раньше
относиться: относятся
еще: ещ
грузовой: грузовые
обычный: обычные
транспорт: транспорта
борт: борту
перевозиться: перевозятся
боеприпас: боеприпасы
продукт: продукты
разворачивать: разворачивают
полевой: полевые
госпиталь: госпитали
разговор: разговор
поздний: позже
классифицироваться: классифицируются
индустриальный: индустриальные
просто: просто
армия: армия
гражданский: гражданский
обойтись: обойтись
представлять: Представляем
похожий: похожие
отобрать: отобрали
схожий: схожую
смысл: смысле
литература: литературу
надежда: надежде
предоставить: предоставить
читатель: читателей
больше: больше
вариант: вариантов
интересный: интересные
обсуждение: Обсуждение
собственный: собственные
мнение: мнения
оставить: Оставьте
думать: думаете
указать: Укажите
конкретно: конкретно
понравиться: понравилось
нет: нет
почему: почему
считать: считаете
