заголовок: Заголовок
олег: Олег
данильченко: Данильченко
имперский: Имперский
вояж: вояж
читать: читать
онлайн: онлайн
бесплатно: бесплатно
адрес: Адрес
здесь: Здесь
быть: будешь
возможность: Возможность
весь: вс
текст: текст
электронный: электронной
книга: книге
совершенно: совершенно
целиком: целиком
полный: полном
версия: версию
в: в
некоторый: некоторых
случай: случаях
присутствовать: присутствует
краткий: краткое
содержание: содержание
город: Город
м: М
спб: СПб
год: год
выпуск: выпуска
издательство: издательство
аста: АСТ
издательский: Издательский
дом: дом
ленинград: Ленинград
категория: категорию
боевой: Боевая
фантастика: фантастика
космический: Космическая
на: на
русский: русском
язык: языке
описание: описание
произведение: произведении
предисловие: предисловие
а: а
так: так
же: же
отзыв: отзывы
посетитель: посетителей
доступный: доступны
портал: портале
библиотека: Библиотека
либ: Либ
кат: Кат
создать: создана
для: для
любитель: любителей
полистать: полистать
хороший: хорошую
книжка: книжку
и: и
предлагать: предлагал
широкий: широкий
выбор: выбора
жанр: жанров
любовный: любовные
роман: романы
фэнтези: фэнтези
приключение: приключения
детектив: детективы
триллер: триллеры
эротика: эротика
документальный: документальные
научный: научные
юмористический: юмористические
анекдот: анекдоты
о: о
бизнес: бизнесе
проза: проза
детский: детские
сказка: сказки
религиия: религиии
новинка: новинки
православный: православные
старинный: старинные
про: про
компьютер: компьютеры
программирование: программирование
английский: английском
домоводство: домоводство
поэзия: поэзия
выбрав: Выбрав
по: по
душа: душе
вы: Вы
смочь: сможете
найти: найти
действительно: действительно
стоить: стоящим
насладиться: насладиться
погружение: погружением
мир: мир
воображение: воображения
прочувствовать: прочувствовать
переживание: переживания
герой: героях
или: или
узнать: Узнайте
себя: собой
чтото: Чтото
новый: новые
совершить: совершить
внутренний: внутреннее
открытие: открытие
подробный: Подробная
информация: информацию
ознакомление: ознакомления
текущий: текущему
запрос: запросу
представить: представлен
низкий: Ниже
к: к
чтение: чтение
аннотация: аннотацию
зависеть: зависит
от: от
тот: То
что: что
написать: напишите
сам: самом
автор: автора
если: если
не: не
необходимый: необходимую
комментарий: комментарии
мы: Мы
постараться: постараемся
отыскать: отыскать
она: она
кто: кого
фамилия: фамилию
как: как
звать: зовут
список: списком
его: его
серия: сериям
уважаемые: Уважаемые
правообладатель: правообладатели
размещать: размещать
наш: нашем
сайт: сайте
у: У
любой: любой
зарегистрировать: зарегистрированного
пользователь: пользователя
ваш: ваши
опубликовать: опубликована
без: без
согласие: согласие
пожалуйста: пожалуйста
направить: направьте
жалоба: жалобу
заполните: заполните
форма: форму
обратный: обратной
связь: связи
течение: течение
час: часов
закрыть: закроем
доступ: доступ
нелегально: нелегально
разместить: размещенному
контент: контенту
разбить: разбитый
страница: страницу
система: Система
сохранение: сохранения
место: места
последний: последней
прочитать: прочитанные
позволять: позволяет
с: с
удобство: удобством
необходимость: необходимости
каждый: каждый
раз: раз
заново: заново
искать: искать
остановиться: остановились
поставить: Поставьте
закладка: Закладка
момент: момент
перейти: перейти
который: которой
закончить: Закончить
шрифт: Шрифт
интервал: Интервал
сказать: сказал
правда: правде
я: меня
пробовать: пробовала
смотреть: смотреть
ситуация: ситуацию
под: под
такой: таким
угол: углом
мочь: можете
ты: ты
право: прав
только: только
он: он
подход: подход
этот: этот
да: Да
разница: разницу
сеть: сетей
имплант: имплантами
забывать: забывать
бы: бы
стать: стать
улыбнуться: улыбнулся
илюха: Илюха
просто: просто
это: этого
учитывать: учитывать
вот: вот
какойто: какимито
план: план
нахмуриться: Нахмурилась
беррана: Беррана
милла: Милла
рилла: Рилла
сидеть: сидел
суслик: суслики
навострив: навострив
розовый: розовые
ушко: ушки
давать: Давай
уже: уже
говорить: Говорил
начать: начала
почему: почему
из: из
вытягивать: вытягивать
приходиться: приходится
начало: начала
прояснить: проясним
между: между
откинуться: Откинулся
спинка: спинку
стул: стула
илья: Илью
действовать: действовать
команда: команде
действуем: действуем
сообща: сообща
один: одна
учиться: учимся
за: за
другой: другое
нужный: нужна
хотеть: хотите
лидер: лидер
правильно: Правильно
понять: поняла
скептически: Скептически
скривиться: скривилась
девушка: девушка
нет: нет
неправильный: неправильно
сразу: Сразу
расставить: расставить
точка: точки
над: над
никуда: никуда
набиваться: набиваюсь
никто: никого
тащить: тащить
цель: цель
идти: идти
напролом: напролом
невзирая: невзирая
препятствие: препятствия
хорошо: хорошо
тоже: тоже
катастрофа: катастрофа
вместе: вместе
чтолибо: чтолибо
делать: делать
простой: проще
чем: чем
поодиночке: поодиночке
прийти: пришли
сюда: сюда
но: но
главный: главных
богадельня: богадельню
верно: Верно
объединить: объединить
усилие: усилия
эй: Эй
неудачник: неудачники
столовая: столовой
объявиться: объявился
пил: Пиле
свой: свои
свита: свитой
знать: знал
распределить: распределят
валах: Валаху
недолго: недолго
остаться: осталось
еще: ещ
ни: ни
группа: группа
дойти: дойди
до: до
конец: конца
состав: составе
меньше: меньше
сейчас: сейчас
собирать: собирать
вещичка: вещички
заржать: заржал
довольный: довольный
собственный: собственные
красноречие: красноречием
сначала: сначала
инвалид: инвалид
ответить: ответили
землянин: землянина
потом: потом
начинать: начинай
совет: советы
исчезнуть: Исчезни
предупреждать: предупреждаю
дикарь: дикарь
было: было
вега: Вега
угрожающий: угрожающее
движение: движение
проваливать: Проваливай
рявкнуть: рявкнул
вставать: вставая
недвусмысленно: недвусмысленно
класть: кладя
рука: руку
кобура: кобуру
игольник: игольником
постоять: постоял
несколько: несколько
мгновение: мгновений
раздумывать: раздумывая
развернуться: развернулся
быстро: быстро
направиться: направился
стол: столу
ууууфффф: Ууууфффф
выдохнуть: выдохнул
риго: Риго
уж: уж
думать: думаете
драться: драться
прийтись: Придтся
бросить: брось
какой: какие
драка: драка
трус: трус
чувствовать: чувствуй
поддержка: поддержки
родитель: родителя
рыпаться: рыпался
испуганно: испуганно
хлопать: хлопали
глазенки: глазнками
невозмутимость: невозмутимость
казалось: Казалось
ее: е
никак: Никак
затронуть: затронула
словесный: словесная
перепалка: перепалка
напомнить: напомнила
помнить: помню
услышать: услышал
мнение: мнения
работать: работать
первый: первым
отозваться: отозвался
норк: Норк
хор: хором
близняшка: близняшки
решить: решил
должный: Должен
подчиняться: подчиняться
упрямо: Упрямо
тряхнуть: тряхнула
челка: члкой
ну: Ну
расстроиться: расстроился
опять: опять
рыба: рыбу
грабли: грабли
тут: тут
все: вс
время: время
распинаться: распинался
вообще: вообще
понимать: понимаю
упрямый: упрямая
девица: девица
разве: Разве
заводиться: заводиться
девчонка: девчонка
пытаться: пытаешься
навязать: навязать
лидерство: лидерство
ничто: ничего
навязывать: навязываю
мой: моему
надо: надо
предложить: предложи
рассмотреть: рассмотрим
оказаться: окажется
значить: Значит
рулить: рулить
излагать: излагай
мысль: мысли
запутать: запутал
самто: Самто
никакой: никакого
потому: Потому
пока: пока
обсуждать: обсуждать
играть: играть
согласиться: согласились
упереться: уперлась
обвинять: обвиняешь
узурпирование: узурпировании
власть: власти
согласный: согласна
далекий: дальше
счет: счт
четыре: Четыре
пара: пары
глаз: глаз
выжидательный: выжидательно
уставились: уставились
ладно: Ладно
валяться: валялся
капсула: капсуле
можно: можно
нивелировать: нивелировать
отставание: отставание
придумать: придумал
буркнуть: буркнула
надутый: надутая
берран: Беррана
вообщето: вообщето
нельзя: нельзя
уменьшить: уменьшить
равный: равно
отставать: отставать
ктото: ктото
большой: больше
прекрасный: Прекрасный
издевательски: Издевательски
хмыкнуть: хмыкнула
упрямица: упрямица
мозг: мозги
пудрить: пудрил
перебивать: перебивать
то: то
разговор: разговоре
смысл: смысле
смотрите: Смотрите
обидчивый: обидчивые
дело: деле
пристать: пристала
человек: человеку
вступиться: вступилась
рассказывать: рассказывает
представлять: Представляем
внимание: вниманию
похожий: похожие
отобрать: отобрали
схожий: схожую
название: названию
литература: литературу
надежда: надежде
предоставить: предоставить
читатель: читателей
больше: больше
вариант: вариантов
интересный: интересные
обсуждение: Обсуждение
оставить: Оставьте
указать: Укажите
конкретно: конкретно
понравиться: понравилось
считать: считаете
