заголовок: Заголовок
олег: Олег
данильченко: Данильченко
имперский: Имперский
вояж: вояж
читать: читать
онлайн: онлайн
бесплатно: бесплатно
адрес: Адрес
здесь: здесь
быть: было
возможность: Возможность
весь: вс
текст: текст
электронный: электронной
книга: книге
совершенно: совершенно
целиком: целиком
полный: полную
версия: версию
в: в
некоторый: некоторых
случай: случае
присутствовать: присутствует
краткий: краткое
содержание: содержание
город: Город
м: М
спб: СПб
год: год
выпуск: выпуска
издательство: издательство
аста: АСТ
издательский: Издательский
дом: дом
ленинград: Ленинград
категория: категорию
боевой: Боевая
фантастика: фантастика
космический: Космическая
на: на
русский: русском
язык: языка
описание: описание
произведение: произведении
предисловие: предисловие
а: а
так: так
же: же
отзыв: отзывы
посетитель: посетителей
доступный: доступны
портал: портале
библиотека: Библиотека
либ: Либ
кат: Кат
создать: создана
для: для
любитель: любителей
полистать: полистать
хороший: хорошую
книжка: книжку
и: и
предлагать: Предлагаем
широкий: широкий
выбор: выбора
жанр: жанров
любовный: любовные
роман: романы
фэнтези: фэнтези
приключение: приключения
детектив: детективы
триллер: триллеры
эротика: эротика
документальный: документальные
научный: научные
юмористический: юмористические
анекдот: анекдоты
о: о
бизнес: бизнесе
проза: проза
детский: детские
сказка: сказки
религиия: религиии
новинка: новинки
православный: православные
старинный: старинные
про: про
компьютер: компьютеры
программирование: программирование
английский: английском
домоводство: домоводство
поэзия: поэзия
выбрав: Выбрав
по: по
душа: душе
вы: Вы
смочь: смогу
найти: нашли
действительно: действительно
стоить: стоящие
насладиться: насладиться
погружение: погружением
мир: мира
воображение: воображения
прочувствовать: прочувствовать
переживание: переживания
герой: героях
или: или
узнать: узнать
себя: себя
чтото: чтото
новый: новые
совершить: совершить
внутренний: внутреннее
открытие: открытие
подробный: Подробная
информация: информацию
ознакомление: ознакомления
текущий: текущему
запрос: запрос
представить: представлен
низкий: Ниже
к: к
чтение: чтение
аннотация: аннотацию
зависеть: зависит
от: от
тот: Те
что: что
написать: напишите
сам: сам
автор: автора
если: если
не: не
необходимый: необходимую
комментарий: комментарии
мы: Мы
постараться: постараюсь
отыскать: отыскать
она: она
кто: Кто
фамилия: фамилию
как: как
звать: зовут
список: списком
его: его
серия: сериям
уважаемые: Уважаемые
правообладатель: правообладатели
размещать: размещать
наш: нашей
сайт: сайте
у: у
любой: любой
зарегистрировать: зарегистрированного
пользователь: пользователя
ваш: ваши
опубликовать: опубликована
без: без
согласие: согласия
пожалуйста: пожалуйста
направить: направьте
жалоба: жалобу
заполните: заполните
форма: форму
обратный: обратной
связь: связи
течение: течение
час: часов
закрыть: закрытая
доступ: доступ
нелегально: нелегально
разместить: размещенному
контент: контенту
разбить: разбили
страница: страницу
система: системе
сохранение: сохранения
место: места
последний: последней
прочитать: прочитанные
позволять: позволяет
с: с
удобство: удобством
необходимость: необходимости
каждый: каждый
раз: раз
заново: заново
искать: искать
остановиться: остановились
поставить: Поставьте
закладка: Закладка
момент: момент
перейти: перейти
который: который
закончить: закончил
шрифт: Шрифт
интервал: Интервал
хм: Хм
док: док
это: это
конечно: конечно
очень: очень
познавательный: познавательно
крайне: крайне
интересный: интересные
но: но
дело: дело
я: меня
знать: зная
местный: местной
кухня: кухне
чудопечка: чудопечка
вряд: вряд
ли: ли
разбираться: разбирается
мой: мом
находить: нахожу
ведь: ведь
правда: правда
простить: простите
както: както
подумать: подумать
давать: дат
поступить: поступим
проще: проще
попробуйте: Попробуйте
объяснить: объяснить
общий: общими
слово: словами
желать: желаете
чтонибудь: чтонибудь
выбрать: выбрать
ну: Ну
ж: ж
попробовать: попробую
согласиться: согласился
илья: Илья
бы: бы
хотеть: хотели
жареный: жареный
кусок: кусок
мясо: мяса
сильно: сильно
жирный: жирный
сухой: сухой
гарнир: гарниром
из: из
какойнибудь: какогонибудь
зерновой: зерновых
культура: культур
должный: должно
подобный: подобное
тааак: Тааак
дайтека: дайтека
доктор: Доктор
набрать: набрал
панель: панелью
какойто: какуюто
комбинация: комбинацию
вот: вот
думать: думаете
подойти: подойдт
через: через
минута: минуту
открыться: открылась
получить: получил
контейнер: Контейнер
размер: размером
сантиметр: сантиметров
раскрыться: раскрылся
чемодан: чемодан
результат: результате
получиться: Получилось
некий: некое
подобие: подобие
поднос: подноса
разный: разных
ячейка: ячейках
находиться: находитесь
пища: пища
пока: пока
тонкий: тонкими
мембрана: мембраны
далее: Далее
уже: уже
несложный: несложно
один: один
край: края
язычок: язычок
потянуть: потянув
за: за
легко: легко
отделяться: отделялась
можно: можно
попить: попить
фруктовый: фруктовый
сок: сока
чтобы: Чтобы
мера: меру
сладкий: сладкий
кислый: кислый
да: да
запросто: запросто
снова: снова
поколдовать: поколдовал
несколько: несколько
секунда: секунд
илюха: Илюха
большой: большой
пластиковый: пластиковый
стакан: стакан
предположительно: предположительно
цвет: цвет
розовый: розовым
он: его
удовлетворенно: удовлетворенно
кивнуть: кивнул
соглашаться: соглашаясь
собеседник: собеседника
итак: Итак
накопиться: накопилось
много: много
вопрос: вопрос
мочь: Можете
они: они
задать: задан
спешить: спешите
молодой: молодой
человек: люди
свой: свой
время: время
начало: начала
познакомиться: познакомимся
грег: Грег
тори: Тори
настоящий: настоящее
имя: имя
значить: значит
сказать: сказали
удивиться: удивился
стоп: стоп
подругому: подругому
сейчас: сейчас
кратко: кратко
рассказать: расскажу
оказаться: оказался
потом: потом
продолжить: продолжим
знакомство: знакомство
борт: борту
лк: ЛК
линейный: линейный
крейсер: Крейсер
непобедимый: Непобедимый
вкс: ВКС
военнокосмический: Военнокосмических
сила: сил
империя: империи
кадар: Кадар
выполнять: выполняет
задача: задачу
состоять: состоит
патрулирование: патрулировании
пограничный: пограничных
такой: такая
обнаружить: обнаружили
отвечать: отвечающий
фрегат: фрегата
капитан: капитан
проигнорировать: проигнорировал
приказ: приказ
принятие: принятии
досмотровый: досмотровой
группа: группы
попытаться: попытался
скрыться: скрыться
естественный: Естественно
вопиющий: вопиющее
нарушение: нарушение
закон: законов
этот: Этот
взять: взяли
абордаж: абордаж
судно: судна
захватить: захвачен
плен: плен
запретить: запрещенные
добыча: добычу
лицензия: лицензии
стратегический: стратегические
полезный: полезные
ископаемое: ископаемые
верный: вернее
даже: даже
их: их
концентрат: концентрат
также: также
криокамера: криокамера
естественно: Естественно
одежда: одежды
улыбнуться: Улыбнулся
допрос: допросе
поддать: подданным
государство: государства
мара: Мар
признаться: признался
вести: вели
разрешение: разрешения
планета: планете
суук: Суук
где: где
задержать: задержан
поведать: поведал
там: там
при: при
непонятный: непонятных
обстоятельство: обстоятельствах
сначала: Сначала
клясться: клялся
сдать: сдать
власть: властям
первый: первое
станция: станции
врать: Врал
после: после
небольшой: небольшой
обработка: обработки
сознаться: сознался
везти: вз
продажа: продажу
считать: считаете
повезти: повезло
воткнуть: воткнули
рабский: рабскую
нейросеть: нейросеть
сгинуть: сгинули
навсегда: навсегда
например: например
гарем: гареме
богатый: богатого
извращенец: извращенца
еще: ещ
похуже: похуже
вроде: вроде
арена: арены
проводить: проводят
бой: бои
правило: правил
до: до
смерть: смерти
история: история
вкратце: вкратце
уставиться: уставился
ожидать: ожидая
реакция: реакции
теперь: Теперь
становиться: становилось
понятный: понятно
понимать: понимаю
чуточку: чуточку
больше: больше
произнести: произнес
ответ: ответа
ответить: ответите
надеяться: Надеюсь
непременно: непременно
забыть: забыли
напомнить: напомню
минимум: минимум
нет: нет
сергеевич: Сергеевич
леонов: Леоновых
длинный: длинно
пояснить: пояснить
аналог: аналогов
лично: Лично
отчество: Отчество
понять: понять
окружать: окружающим
отец: отца
сергей: Сергей
принадлежность: принадлежность
род: родами
определить: определить
рабство: рабство
горько: горько
усмехнуться: усмехнулся
почемуто: почемуто
когда: когда
только: только
два: две
часть: части
лео: Лео
этото: этото
более: более
менее: менее
похожий: похожие
привычный: привычное
звучание: звучание
хорошо: Хорошо
илио: Илио
перековеркать: перековеркал
манер: манер
живете: живте
представлять: Представляем
внимание: вниманию
отобрать: отобрали
схожий: схожую
название: названию
смысл: смысле
литература: литературу
надежда: надежде
предоставить: предоставить
читатель: читателей
вариант: вариантов
обсуждение: Обсуждение
просто: просто
собственный: собственные
мнение: мнения
оставить: Оставьте
главный: главных
указать: Укажите
конкретно: конкретно
понравиться: понравилось
почему: почему
