заголовок: Заголовок
олег: Олег
данильченко: Данильченко
имперский: Имперский
вояж: вояж
читать: читать
онлайн: онлайн
бесплатно: бесплатно
адрес: Адрес
здесь: здесь
быть: будет
возможность: Возможность
весь: всего
текст: текст
электронный: электронной
книга: книге
совершенно: совершенно
целиком: целиком
полный: полную
версия: версию
в: в
некоторый: некоторыми
случай: случае
присутствовать: присутствуют
краткий: краткое
содержание: содержание
город: Город
м: М
спб: СПб
год: год
выпуск: выпуска
издательство: издательство
аста: АСТ
издательский: Издательский
дом: дом
ленинград: Ленинград
категория: категорию
боевой: Боевая
фантастика: фантастика
космический: Космическая
на: на
русский: русском
язык: языке
описание: описание
произведение: произведении
предисловие: предисловие
а: а
так: так
же: же
отзыв: отзывы
посетитель: посетителей
доступный: доступны
портал: портале
библиотека: Библиотека
либ: Либ
кат: Кат
создать: создана
для: для
любитель: любителей
полистать: полистать
хороший: Хорошо
книжка: книжках
и: и
предлагать: Предлагаем
широкий: широкий
выбор: выбора
жанр: жанра
любовный: любовные
роман: романы
фэнтези: фэнтези
приключение: приключения
детектив: детективы
триллер: триллеры
эротика: эротика
документальный: документальные
научный: научные
юмористический: юмористические
анекдот: анекдоты
о: о
бизнес: бизнесе
проза: проза
детский: детские
сказка: сказки
религиия: религиии
новинка: новинки
православный: православные
старинный: старинные
про: про
компьютер: компьютеры
программирование: программирование
английский: английском
домоводство: домоводство
поэзия: поэзия
выбрав: Выбрав
по: по
душа: душе
вы: Вы
смочь: сможете
найти: найти
действительно: действительно
стоить: стоить
насладиться: насладиться
погружение: погружением
мир: мир
воображение: воображения
прочувствовать: прочувствовать
переживание: переживания
герой: героях
или: или
узнать: Узнайте
себя: себе
чтото: чтото
новый: новые
совершить: совершить
внутренний: внутреннее
открытие: открытие
подробный: Подробная
информация: информацию
ознакомление: ознакомления
текущий: текущему
запрос: запросу
представить: представлен
низкий: Ниже
к: к
чтение: чтение
аннотация: аннотацию
зависеть: зависит
от: от
тот: тем
что: что
написать: напишите
сам: самом
автор: автора
если: если
не: не
необходимый: необходимую
комментарий: комментарии
мы: Мы
постараться: постараемся
отыскать: отыскать
она: Она
кто: Кто
фамилия: фамилию
как: как
звать: зовут
список: списком
его: его
серия: сериям
уважаемые: Уважаемые
правообладатель: правообладатели
размещать: размещать
наш: нашем
сайт: сайте
у: у
любой: любые
зарегистрировать: зарегистрированного
пользователь: пользователя
ваш: ваши
опубликовать: опубликована
без: без
согласие: согласие
пожалуйста: пожалуйста
направить: направьте
жалоба: жалобу
заполните: заполните
форма: форму
обратный: обратной
связь: связи
течение: течение
час: час
закрыть: закроем
доступ: доступ
нелегально: нелегально
разместить: размещенному
контент: контенту
разбить: разбитый
страница: страницу
система: Система
сохранение: сохранения
место: место
последний: последней
прочитать: прочитанные
позволять: позволяет
с: со
удобство: удобством
необходимость: необходимости
каждый: каждый
раз: раз
заново: заново
искать: искать
остановиться: остановились
поставить: Поставьте
закладка: Закладка
момент: момент
перейти: перейти
который: который
закончить: закончили
шрифт: Шрифт
интервал: Интервал
проблема: Проблема
доброволец: доброволец
но: Но
он: он
буквально: буквально
назад: назад
отказаться: отказался
участие: участия
эксперимент: эксперимент
подозревать: Подозреваю
конкурент: конкуренты
хорошо: хорошо
заплатить: заплатили
теперь: теперь
я: я
более: более
чем: чем
уверенный: уверен
способ: способами
они: них
дать: дадут
другой: другого
важный: важно
простой: простой
причина: причине
уже: уже
никто: никто
знать: знаете
при: при
это: Это
иметь: имеет
нейросеть: нейросети
вообще: вообще
идеальный: Идеальный
договориться: договоримся
то: то
прямо: прямо
отсюда: отсюда
отправиться: отправимся
лаборатория: лабораторию
взять: возьмм
создание: создания
экспериментальный: экспериментальной
сеть: сеть
образец: образца
ткань: ткани
завтра: завтра
утро: утра
провести: проведм
еще: ещ
два: Двум
день: дня
понадобиться: понадобится
чтобы: чтобы
после: После
активация: активации
опытный: опытного
задокументировать: задокументировать
под: под
протокол: протокол
показание: показания
организм: организма
свободный: свободны
заманчиво: Заманчиво
конечно: конечно
задумчиво: задумчиво
ответить: ответил
немой: немой
вопрос: вопрос
взгляд: взгляде
гореученый: гореучного
илья: Илья
какой: какие
опасность: опасности
лично: лично
опробовать: опробованная
технология: технология
верно: верно
пойти: пойдт
план: плану
дома: дома
такой: таких
поговорка: поговорка
гладкий: Гладко
бумага: бумаге
да: да
забыть: забыли
овраг: овраги
всегда: всегда
существовать: существует
вероятность: вероятностью
ошибка: ошибки
ученый: ученый
должный: должны
понимать: понимать
естественно: Естественно
прах: прахом
уверять: уверяю
проверить: проверили
тщательно: тщательно
считать: считаете
успех: успеха
равный: равна
восемьдесят: восемьдесят
пять: пяти
процент: процентам
очень: очень
показатель: показатель
дело: деле
сказать: сказали
большой: больше
постоянный: постоянным
наблюдение: наблюдением
специалист: специалистов
свой: своей
область: области
время: времени
проведение: проведения
давать: давайте
дополнительный: дополнительные
шанс: шансы
здоровье: здоровьем
ничто: ничего
угрожать: угрожает
скорый: скорее
успеть: успеем
заменить: заменить
прототип: прототип
выбрать: выбрали
ранее: ранее
до: до
мочь: может
начаться: начаться
необратимый: необратимые
процесс: процессы
возместить: возместим
материально: материально
неудобство: неудобства
также: также
потратить: потраченное
илюха: Илюха
задуматься: задумался
похоже: Похоже
судьба: судьба
решить: решила
подогнать: подогнать
рояль: рояли
куст: кустам
коля: Коль
скоро: скоро
стать: стать
попаданец: попаданцем
земной: земных
закон: закону
просто: просто
обязанный: обязан
получить: получите
подобный: подобное
вот: Вот
только: только
обычно: обычно
этот: эти
стоять: стоят
повсюду: повсюду
халява: халяву
лениться: ленись
шастать: шастать
тут: тут
надо: надо
рисковать: рисковать
летальный: летального
исход: исхода
однако: Однако
задачка: задачка
зато: зато
успешный: успешном
завершение: завершении
хм: хм
весьма: весьма
сомнительный: сомнительного
мероприятие: мероприятия
старт: старт
мечтать: мечтать
снизойти: снизошло
какойто: какихто
бесшабашный: бесшабашное
веселие: веселье
собственно: собственно
бояться: боится
ведь: Ведь
умирать: умирал
несколько: несколько
земля: Земле
подавно: подавно
числиться: числится
мертвый: мртвым
говориться: говорится
смерть: смертью
бывать: бывать
один: одного
миновать: миновать
почувствовать: почувствовал
кураж: кураж
няга: Нягу
согласиться: соглашусь
принять: приму
предложение: предложение
глядеть: глядя
умоляющий: умоляющие
глаз: глазах
дополнение: дополнениями
вопервых: Вопервых
установить: установил
имплантат: имплантат
интеллект: интеллект
сотня: сотню
пункт: пунктов
потянуть: потянет
думать: думаете
кредит: кредита
подбросить: подбросите
мой: мои
личный: личный
счет: счт
тысяча: тысяч
пятьсот: пятьсот
продешевить: продешевил
жадничать: жадничать
устраивать: устраивают
условие: условия
заключать: заключать
сделка: сделку
ум: уме
сойти: сошли
воскликнуть: воскликнул
сколько: сколько
удачный: удачного
миллион: миллионов
шестьдесят: шестидесяти
меньше: меньше
ее: е
требовать: требую
больше: больше
выразиться: выразились
перевести: перевести
неслыханный: неслыханная
наглость: наглость
держать: держать
за: за
дурак: дурака
повысить: повысил
голос: голос
разработка: разработка
пока: пока
сорваться: сорвтся
надеяться: надеялись
лечь: лягу
нож: нож
оттуда: оттуда
встать: встану
попросить: попрошу
риск: риск
бонус: бонусов
глубоко: глубоко
заблуждаться: заблуждаетесь
дикарь: дикарь
позволить: позволю
распоряжаться: распоряжаться
жизнь: жизни
здорово: здорово
жить: жившь
возможно: возможно
зажмотить: зажмотили
жалкий: жалких
полтора: полтора
жадность: жадности
обстоятельство: обстоятельствах
видеть: видел
точно: точно
уверить: уверены
правильно: правильно
профессия: профессию
торгаш: торгашом
даже: даже
смертный: смертном
одр: одре
торг: торги
устроить: устроите
согласный: Согласен
бездна: бездна
побрать: побери
готовый: готов
заключить: заключить
договор: договор
подождать: Подождите
уважаемый: уважаемый
ну: Ну
зарычать: зарычал
взбесить: взбешенный
делать: делать
сразу: сразу
ехидно: ехидно
заявить: заявил
наговорить: наговорили
база: базы
знание: знаний
советовать: советую
соглашаться: соглашаться
потому: потому
противный: противном
цена: цена
возрастать: возрастать
нет: нет
представлять: Представляем
внимание: вниманию
похожий: похожие
отобрать: отобрали
схожий: схожую
название: названию
смысл: смысле
литература: литературу
надежда: надежде
предоставить: предоставить
читатель: читателей
вариант: вариантов
интересный: интересные
обсуждение: Обсуждение
собственный: собственные
мнение: мнения
оставить: Оставьте
главный: главных
указать: Укажите
конкретно: конкретно
понравиться: понравилось
почему: почему
