заголовок: Заголовок
олег: Олег
данильченко: Данильченко
имперский: Имперский
вояж: вояж
читать: читать
онлайн: онлайн
бесплатно: бесплатно
адрес: Адрес
здесь: Здесь
быть: есть
возможность: Возможность
весь: вс
текст: текст
электронный: электронной
книга: книге
совершенно: совершенно
целиком: целиком
полный: полную
версия: версию
в: в
некоторый: некоторых
случай: случай
присутствовать: присутствует
краткий: краткое
содержание: содержание
город: Город
м: М
спб: СПб
год: года
выпуск: выпуска
издательство: издательство
аста: АСТ
издательский: Издательский
дом: дом
ленинград: Ленинград
категория: категорию
боевой: боевых
фантастика: фантастика
космический: Космическая
на: на
русский: русском
язык: язык
описание: описание
произведение: произведении
предисловие: предисловие
а: а
так: так
же: же
отзыв: отзывы
посетитель: посетителей
доступный: доступны
портал: портале
библиотека: Библиотека
либ: Либ
кат: Кат
создать: создана
для: для
любитель: любителей
полистать: полистать
хороший: лучшем
книжка: книжку
и: и
предлагать: Предлагаем
широкий: широкий
выбор: выбора
жанр: жанров
любовный: любовные
роман: романы
фэнтези: фэнтези
приключение: приключения
детектив: детективы
триллер: триллеры
эротика: эротика
документальный: документальные
научный: научные
юмористический: юмористические
анекдот: анекдоты
о: о
бизнес: бизнесе
проза: проза
детский: детские
сказка: сказки
религиия: религиии
новинка: новинки
православный: православные
старинный: старинные
про: про
компьютер: компьютеры
программирование: программирование
английский: английском
домоводство: домоводство
поэзия: поэзия
выбрав: Выбрав
по: по
душа: душе
вы: Вы
смочь: смог
найти: нашли
действительно: действительно
стоить: стоящие
насладиться: насладиться
погружение: погружением
мир: мир
воображение: воображения
прочувствовать: прочувствовать
переживание: переживания
герой: героях
или: или
узнать: Узнайте
себя: себя
чтото: чтото
новый: новые
совершить: совершить
внутренний: внутреннее
открытие: открытие
подробный: Подробная
информация: информацию
ознакомление: ознакомления
текущий: текущему
запрос: запросу
представить: представлен
низкий: Ниже
к: к
чтение: чтение
аннотация: аннотацию
зависеть: зависит
от: от
тот: тем
что: что
написать: напишите
сам: сам
автор: автора
если: если
не: не
необходимый: необходимую
комментарий: комментарии
мы: Мы
постараться: постараемся
отыскать: отыскать
она: е
кто: Кто
фамилия: фамилию
как: как
звать: зовут
список: списком
его: его
серия: сериям
уважаемые: Уважаемые
правообладатель: правообладатели
размещать: размещать
наш: нашем
сайт: сайте
у: у
любой: любой
зарегистрировать: зарегистрированного
пользователь: пользователя
ваш: ваши
опубликовать: опубликована
без: без
согласие: согласия
пожалуйста: пожалуйста
направить: направьте
жалоба: жалобу
заполните: заполните
форма: форму
обратный: обратной
связь: связи
течение: течение
час: часов
закрыть: закроем
доступ: доступе
нелегально: нелегально
разместить: размещенному
контент: контенту
разбить: разбитый
страница: страницу
система: Система
сохранение: сохранения
место: месте
последний: последний
прочитать: прочитанные
позволять: позволяет
с: с
удобство: удобством
необходимость: необходимости
каждый: каждый
раз: раза
заново: заново
искать: искать
остановиться: остановились
поставить: Поставьте
закладка: Закладка
момент: момента
перейти: перейти
который: который
закончить: закончили
шрифт: Шрифт
интервал: Интервал
няга: Нягу
казаться: казалось
ждать: ждал
вызов: вызова
потому: потому
ответить: ответил
сразу: сразу
тут: Тут
завалить: завалил
вопрос: вопросы
самочувствие: самочувствию
работа: работе
сеть: сеть
ну: ну
прочий: прочим
умный: умным
словесный: словесным
хлам: хламом
пообщаться: Пообщавшись
такой: такой
образ: образом
полчаса: полчаса
илья: Илья
напомнить: напомнил
долг: долг
предложить: предложил
изменить: изменить
условие: условия
объяснить: Объяснив
база: базы
мочь: могли
предоставить: предоставить
уважаемый: уважаемый
ученый: Учный
идти: идущая
ни: ни
какой: какую
сравнение: сравнение
военный: военными
иметься: имеющимися
открыть: открытом
курсант: курсантов
прийтись: Пришлось
согласиться: согласился
но: но
эскулап: эскулап
поспособствовать: поспособствовать
приобретение: приобретении
разгонный: разгонных
картридж: картриджи
то: то
он: он
благодарный: благодарен
более: более
этот: этому
стоять: стоят
намного: намного
дешевый: дешевле
количество: количество
изначально: изначально
оговариваться: оговаривалось
смысл: смысле
плохо: плохо
воспитанный: воспитанным
человек: человеком
бы: бы
разорить: разорить
несчастный: несчастного
профессор: профессора
онто: онто
поэтому: поэтому
всего: всего
лишь: лишь
просить: просит
обеспечить: обеспечить
химия: химией
еще: ещ
четверо: четверых
друг: друзья
нет: нет
конечно: конечно
курс: курс
обучение: обучения
только: Только
требование: требованию
протяжение: протяжении
личный: Личные
данные: данные
изготовление: изготовления
препарат: препарата
прилагаться: прилагаются
начать: начал
упираться: упираться
сначала: сначала
потом: потом
взвесить: взвесив
за: за
против: против
вернуть: Вернув
илюха: Илюха
собственный: собственные
шпилька: шпильку
повод: поводу
правильность: правильности
профессия: профессии
мол: мол
способность: способностями
мертвый: мртвого
можно: можно
уговорить: уговорить
договориться: договориться
также: также
отправлять: отправлять
посылка: посылке
имя: имя
землянин: землянин
непосредственный: непосредственного
куратор: куратора
господин: господина
черим: Черимом
бал: Балах
зачем: Зачем
договоренность: договоренности
знать: знать
напоследок: напоследок
чтобы: чтобы
забывать: забывал
отчет: отчты
свой: сво
сказать: сказав
совместный: совместном
проживание: проживании
очередь: очередь
заверить: заверил
помнить: помнит
сделать: сделала
вид: вида
порешили: порешили
кстати: Кстати
прежде: Прежде
чем: чем
разговаривать: разговаривать
непосредственно: непосредственно
хотеть: хотел
соглашаться: соглашаться
упирать: упирая
комплекс: комплекс
сбалансировать: сбалансирован
вообще: вообще
принять: принято
никакой: Никакие
довод: доводы
переубедить: переубедить
помочь: помочь
дело: Дело
счет: счт
нестандартный: нестандартного
симбионт: симбионта
просто: просто
уже: уже
поворачиваться: поворачивался
называть: называть
опережать: опережал
даже: даже
график: график
стать: стали
появляться: появляться
свободный: свободное
время: время
когда: Когда
вылезать: вылезали
из: из
мозгодробительный: мозгодробительных
капсула: капсул
там: там
естественно: естественно
понятный: понятно
они: они
возмущаться: возмущаться
сознаться: сознаться
вернее: Вернее
придумать: придумать
история: историю
нелегальный: нелегальную
седьмой: седьмого
поколение: поколения
идентификатор: идентификатором
муэлита: МУЭлит
это: это
снять: сняло
неудобный: неудобные
хотя: хотя
врать: врать
хотеться: хотелось
куда: куда
деваться: деваться
договор: договор
вот: вот
решить: решил
посвятить: посвятить
физический: физическому
подготовка: подготовке
изучить: Изучив
знание: знаний
рукопашка: рукопашке
упоение: упоением
отдался: отдался
тренировка: тренировки
попутно: Попутно
удовольствие: удовольствия
заметить: заметил
значительно: значительно
возрасти: возросли
сильный: сильнее
быстрый: быстрее
ребята: ребят
тоже: тоже
забыть: забыл
регулярно: регулярно
вытаскивать: вытаскивал
спортзал: спортзал
гонять: гонял
нещадно: нещадно
невзирая: невзирая
пол: полу
близняшка: Близняшкам
пойти: пошло
польза: пользу
вопервых: Вопервых
отвлекать: отвлекало
нудный: нудного
зубрение: зубрения
вовторых: вовторых
очень: очень
соблазнительный: соблазнительные
фигурка: фигурки
привлекательнее: привлекательнее
скинуть: скинув
несколько: несколько
лишний: лишних
килограмм: килограммов
посвящать: посвящали
труд: труду
пара: пара
три: три
неделя: неделю
торчать: торчал
постоянно: постоянно
один: один
день: дней
возвращаться: возвращаясь
очередной: очередной
обратить: обратил
внимание: вниманию
мужчина: мужчину
почтенный: почтенного
возраст: возраста
настолько: настолько
проще: проще
дед: деда
удивиться: удивился
ведь: ведь
до: до
сей: сего
старик: старик
видеть: видеть
приходиться: приходилось
пролонг: пролонга
както: както
совсем: совсем
обычный: обычную
старость: старость
первый: первого
проходить: проходил
создаться: создалось
обманчивый: обманчивое
впечатление: впечатление
вечность: вечности
поди: поди
ж: ж
ты: ты
оказываться: оказывается
старикто: старикито
однако: Однако
выглядеть: выглядел
дряхлый: дряхлым
рослый: Рослый
дедка: Дедок
вполне: вполне
бодрый: бодрого
хоть: хоть
сморщить: сморщенный
прилично: прилично
собирать: собирал
рассыпать: рассыпанное
ручной: ручное
вооружение: вооружение
сегмент: сегментами
скафандр: скафандров
складывать: складывать
гравиплатформ: гравиплатформу
добро: добро
поход: походу
рухнуть: рухнуло
пройти: пройти
мимо: мимо
впереди: впереди
разрешить: Разрешите
спросить: спросил
дожидаться: дожидаясь
ответ: ответа
имущество: имущество
хмыкнуть: хмыкнул
ничто: ничего
продолжить: продолжил
секунда: секунду
прервать: прерванное
занятие: занятие
четыре: четыре
рука: руках
быстро: быстро
справиться: справились
разогнуться: разогнулся
укладывая: укладывая
фрагмент: фрагмент
бронь: брони
платформа: платформу
ухмыляясь: ухмыляясь
смотреть: смотрит
оглядев: Оглядев
смешной: смешного
обнаружить: обнаружил
полотенце: Полотенце
обмотать: обмотанное
вокруг: вокруг
талия: талии
мокрый: мокрый
пот: пота
спортивный: спортивный
костюм: костюм
держать: держал
спрашивается: спрашивается
лыба: лыбу
давить: давит
представлять: Представляем
похожий: похожие
отобрать: отобрали
схожий: схожую
название: названию
литература: литературу
надежда: надежде
читатель: читателей
больше: больше
вариант: вариантов
интересный: интересные
обсуждение: Обсуждение
мнение: мнения
оставить: Оставьте
думать: думаете
главный: главных
указать: Укажите
конкретно: конкретно
понравиться: понравилось
почему: почему
считать: считаете
