заголовок: Заголовок
олег: Олег
данильченко: Данильченко
имперский: Имперский
вояж: вояж
читать: читать
онлайн: онлайн
бесплатно: бесплатно
адрес: Адрес
здесь: здесь
быть: будем
возможность: Возможность
весь: весь
текст: текст
электронный: электронной
книга: книге
совершенно: совершенно
целиком: целиком
полный: полную
версия: версию
в: в
некоторый: некоторых
случай: случаях
присутствовать: присутствует
краткий: краткое
содержание: содержание
город: Город
м: М
спб: СПб
год: год
выпуск: выпуска
издательство: издательство
аста: АСТ
издательский: Издательский
дом: дом
ленинград: Ленинград
категория: категорию
боевой: боевого
фантастика: фантастика
космический: Космическая
на: на
русский: русском
язык: языке
описание: описание
произведение: произведении
предисловие: предисловие
а: а
так: так
же: же
отзыв: отзывы
посетитель: посетителей
доступный: доступны
портал: портале
библиотека: Библиотека
либ: Либ
кат: Кат
создать: создана
для: для
любитель: любителей
полистать: полистать
хороший: хороший
книжка: книжку
и: и
предлагать: Предлагаем
широкий: широким
выбор: выбора
жанр: жанров
любовный: любовные
роман: романы
фэнтези: фэнтези
приключение: приключения
детектив: детективы
триллер: триллеры
эротика: эротика
документальный: документальные
научный: научные
юмористический: юмористические
анекдот: анекдоты
о: о
бизнес: бизнесе
проза: проза
детский: детские
сказка: сказки
религиия: религиии
новинка: новинки
православный: православные
старинный: старинные
про: про
компьютер: компьютеры
программирование: программирование
английский: английском
домоводство: домоводство
поэзия: поэзия
выбрав: Выбрав
по: по
душа: душе
вы: Вы
смочь: смог
найти: найдя
действительно: действительно
стоить: стоит
насладиться: насладиться
погружение: погружением
мир: мир
воображение: воображения
прочувствовать: прочувствовать
переживание: переживания
герой: героях
или: или
узнать: Узнайте
себя: себе
чтото: чтото
новый: новые
совершить: совершить
внутренний: внутреннее
открытие: открытие
подробный: Подробная
информация: информацию
ознакомление: ознакомления
текущий: текущему
запрос: запросу
представить: представлен
низкий: Ниже
к: к
чтение: чтение
аннотация: аннотацию
зависеть: зависит
от: от
тот: том
что: что
написать: напишите
сам: сам
автор: автора
если: Если
не: не
необходимый: необходимую
комментарий: комментарии
мы: Мы
постараться: постараемся
отыскать: отыскать
она: не
кто: Кто
фамилия: фамилию
как: как
звать: зовут
список: списком
его: его
серия: сериям
уважаемые: Уважаемые
правообладатель: правообладатели
размещать: размещать
наш: нашем
сайт: сайте
у: у
любой: любой
зарегистрировать: зарегистрированного
пользователь: пользователя
ваш: ваши
опубликовать: опубликована
без: без
согласие: согласия
пожалуйста: пожалуйста
направить: направьте
жалоба: жалобу
заполните: заполните
форма: форму
обратный: обратном
связь: связи
течение: течение
час: часов
закрыть: закроем
доступ: доступ
нелегально: нелегально
разместить: размещенному
контент: контенту
разбить: разбитый
страница: страницу
система: Система
сохранение: сохранения
место: места
последний: последние
прочитать: прочитанные
позволять: позволяет
с: с
удобство: удобством
необходимость: необходимости
каждый: каждый
раз: раз
заново: заново
искать: искать
остановиться: остановились
поставить: Поставьте
закладка: Закладка
момент: момент
перейти: перейти
который: которая
закончить: закончили
шрифт: Шрифт
интервал: Интервал
угу: Угу
вот: вот
деньга: деньги
купить: купить
когда: Когда
понять: понял
пилс: Пилсом
один: Одной
курс: курсе
придется: придтся
учиться: учиться
показать: покажи
да: Да
проблема: Проблема
только: только
подождать: подожди
я: я
сейчас: сейчас
разрядить: разряжу
деактивировать: деактивирую
то: то
он: нему
мой: мою
нейросеть: нейросеть
настроить: настроен
чужой: чужих
рука: руках
мочь: может
ток: током
шибануть: шибануть
риго: Риго
проделать: проделал
нехитрый: нехитрые
манипуляция: манипуляции
предмет: предмет
подать: подал
илья: Илья
рукоятью: рукоятью
вперед: вперед
интересный: интересные
игрушка: игрушка
это: Это
импульсный: Импульсный
станер: станер
парализатор: Парализатор
проще: проще
стрелять: Стреляет
конус: конусом
парализовать: парализующих
излучение: излучения
сколько: Сколько
ты: ты
обойтись: обошлся
недорого: недорого
полтора: полторы
тысяча: тысяч
остаться: остались
открыто: открыто
носить: носишь
разрешить: разрешенное
конечно: конечно
гражданский: гражданским
оружие: оружия
самооборона: самообороны
легальный: легально
покупать: Покупал
уже: уже
станция: станцию
магазин: магазин
серьезный: серьезным
все: вс
оформить: оформили
полагаться: полагается
коль: коль
такой: такой
дело: дело
где: где
тоже: тоже
присмотреть: присмотрю
сппохватиться: сппохватился
вспомнить: вспомнив
завтра: завтра
отпустить: отпустят
пойти: Пошли
легко: легко
согласиться: согласился
норк: Норк
путь: пути
составить: составишь
компания: компанию
куда: куда
еще: ещ
собраться: собрался
хотеть: хотели
обзорк: обзорку
заглянуть: заглянуть
корабль: Корабли
посмотреть: посмотреть
нравиться: Нравится
удовольствие: удовольствием
обрадоваться: обрадовался
лицо: лице
знакомый: знакомого
единомышленник: единомышленника
глава: Глава
поход: Поход
оружейный: оружейный
оказаться: оказалось
познавательный: познавательным
заведение: Заведение
там: там
полка: полок
буквально: буквально
ломиться: ломились
количество: количества
разнообразный: разнообразных
образец: образца
ручной: ручного
вооружение: вооружении
кроме: кроме
торговать: торговали
военный: военного
экипировка: экипировкой
тут: Тут
скафандр: скафандры
иметься: имелись
всевозможный: всевозможные
легкий: легкие
дроид: дроиды
говорить: говорите
просто: просто
одежда: одежде
прийтись: пришлось
немного: немного
подзадержаться: подзадержаться
разглядывать: разглядывающих
этот: этими
богатство: богатства
какойто: какойто
они: их
открыть: открыв
рот: рты
заметить: заметил
продавецконсультант: продавецконсультант
ребята: Ребята
помочь: помочь
спросить: спросил
добродушно: добродушно
улыбаясь: улыбаясь
спохватиться: спохватился
день: днях
приобрести: приобрел
ааа: Ааа
помнить: помню
нет: нет
прекрасный: прекрасно
друг: друг
привести: привели
чтонибудь: чтонибудь
прекрасно: Прекрасно
хорошо: хорошо
сделать: сделали
именно: именно
самый: самый
богатый: богатый
приобретать: приобретать
повторно: повторно
прийти: пришли
скидочка: скидочка
бы: бы
обратиться: обратился
продавец: продавец
понимать: Понимаете
знать: знаю
империя: Империи
всего: Всего
неделя: неделю
увидеть: увидеть
торговец: торговца
собираться: собирается
задать: задать
вопрос: вопрос
добавить: добавил
из: из
дикий: диких
поэтому: Поэтому
слабо: слабо
разбираться: разбираюсь
местный: местном
сказать: сказать
вообще: вообще
ничто: ничего
самостоятельно: самостоятельно
выбрать: выбрать
проблематичный: проблематично
ерунда: Ерунда
отмахнуться: отмахнулся
чтобы: чтобы
ктото: комуто
подобрать: подобрать
хоть: хоть
жизнь: жизни
держать: держали
вещь: вещи
естественно: Естественно
очень: Очень
даже: даже
много: много
хотеться: хотелось
забыть: забыть
но: но
видимо: видимо
выйти: выйдет
родина: родине
похожий: похожие
успеть: успел
затрудняться: затрудняюсь
объяснить: объяснить
принцип: принцип
действие: действия
сложный: сложного
обычный: обычный
огнестрел: огнестрел
порох: Порох
пуля: пуля
трубка: трубка
нарез: нарезами
вылетать: вылетает
поражать: поражая
цель: цель
попасть: попал
понятный: понятно
страшный: страшного
привычнее: привычнее
оперировать: оперировать
метать: метающим
снаряд: снаряды
предложить: предложить
вариант: вариантов
слово: словами
подбежать: подбежал
снять: снял
пистолет: пистолет
игольник: игольник
распространить: распространнная
модель: модель
пучок: пучок
игла: игл
зависимость: зависимости
род: рода
боеприпас: Боеприпасы
оборонительный: оборонительным
прицельный: Прицельная
дальность: дальность
сорок: сорок
метр: метров
далекий: Дальше
рассеивание: рассеивание
становиться: становится
больший: большим
расстояние: расстояния
тридцать: тридцати
поразить: поразит
гарантированно: гарантированно
разрывный: разрывные
бронебойноосколочный: бронебойноосколочные
обойма: обоймы
хватать: хватает
шестьдесят: шестьдесят
выстрел: выстрелов
рекомендовать: Рекомендую
главный: главных
недорогой: недорогой
поскольку: Поскольку
регистрировать: регистрировать
ношение: ношению
заряд: зарядов
большой: больше
нельзя: нельзя
подержать: подержал
несколько: несколько
примериться: примерился
ухватистый: ухватистый
двенадцать: двенадцать
дорогой: дороже
стайер: стайера
зато: зато
получать: получаете
универсальный: универсальную
выполнять: выполнять
функция: функции
защита: защиты
впоследствии: впоследствии
представлять: Представляем
внимание: вниманию
отобрать: отобрали
схожий: схожую
название: названию
смысл: смысле
литература: литературу
надежда: надежде
предоставить: предоставить
читатель: читателей
больше: больше
обсуждение: Обсуждение
собственный: собственные
мнение: мнения
оставить: Оставьте
думать: думаете
указать: Укажите
конкретно: конкретно
понравиться: понравилось
почему: почему
считать: считаете
