заголовок: Заголовок
олег: Олег
данильченко: Данильченко
имперский: Имперский
вояж: вояж
читать: читать
онлайн: онлайн
бесплатно: бесплатно
адрес: Адрес
здесь: Здесь
быть: будет
возможность: Возможность
весь: Вс
текст: текст
электронный: электронной
книга: книге
совершенно: совершенно
целиком: целиком
полный: полными
версия: версию
в: в
некоторый: некоторых
случай: случая
присутствовать: присутствует
краткий: краткое
содержание: содержание
город: Город
м: М
спб: СПб
год: лет
выпуск: выпуска
издательство: издательство
аста: АСТ
издательский: Издательский
дом: дома
ленинград: Ленинград
категория: категорию
боевой: Боевая
фантастика: фантастика
космический: Космическая
на: на
русский: русском
язык: языке
описание: описание
произведение: произведении
предисловие: предисловие
а: а
так: так
же: же
отзыв: отзывы
посетитель: посетителей
доступный: доступны
портал: портале
библиотека: Библиотека
либ: Либ
кат: Кат
создать: создана
для: для
любитель: любителей
полистать: полистать
хороший: лучше
книжка: книжку
и: и
предлагать: Предлагаем
широкий: широкий
выбор: выбора
жанр: жанров
любовный: любовные
роман: романы
фэнтези: фэнтези
приключение: приключения
детектив: детективы
триллер: триллеры
эротика: эротика
документальный: документальные
научный: научные
юмористический: юмористические
анекдот: анекдоты
о: о
бизнес: бизнесе
проза: проза
детский: детские
сказка: сказки
религиия: религиии
новинка: новинки
православный: православные
старинный: старинные
про: про
компьютер: компьютеры
программирование: программирование
английский: английском
домоводство: домоводство
поэзия: поэзия
выбрав: Выбрав
по: по
душа: душе
вы: Вы
смочь: смог
найти: нашли
действительно: действительно
стоить: стой
насладиться: насладиться
погружение: погружением
мир: мир
воображение: воображения
прочувствовать: прочувствовать
переживание: переживания
герой: героях
или: или
узнать: Узнайте
себя: собой
чтото: чтото
новый: новые
совершить: совершить
внутренний: внутреннее
открытие: открытие
подробный: Подробная
информация: информацию
ознакомление: ознакомления
текущий: текущему
запрос: запросу
представить: представлен
низкий: Ниже
к: к
чтение: чтение
аннотация: аннотацию
зависеть: зависит
от: от
тот: того
что: что
написать: напишите
сам: сам
автор: автора
если: если
не: не
необходимый: необходимую
комментарий: комментарии
мы: Мы
постараться: постараемся
отыскать: отыскать
она: е
кто: кто
фамилия: фамилию
как: как
звать: зовут
список: списком
его: его
серия: сериям
уважаемые: Уважаемые
правообладатель: правообладатели
размещать: размещать
наш: нашем
сайт: сайте
у: у
любой: любой
зарегистрировать: зарегистрированного
пользователь: пользователя
ваш: ваши
опубликовать: опубликована
без: без
согласие: согласия
пожалуйста: пожалуйста
направить: направьте
жалоба: жалобу
заполните: заполните
форма: форму
обратный: обратной
связь: связи
течение: течение
час: часов
закрыть: закроем
доступ: доступ
нелегально: нелегально
разместить: размещенному
контент: контенту
разбить: разбитый
страница: страницу
система: Система
сохранение: сохранения
место: места
последний: последней
прочитать: прочитанные
позволять: позволяет
с: со
удобство: удобством
необходимость: необходимости
каждый: каждый
раз: раз
заново: заново
искать: искать
остановиться: остановились
поставить: Поставьте
закладка: Закладка
момент: момент
перейти: перейти
который: которой
закончить: закончили
шрифт: Шрифт
интервал: Интервал
опа: Опа
очнуться: очнулся
голос: Голос
говорить: говорившего
отчегото: отчегото
знакомый: знакомы
илья: Илья
хотеть: хочет
сказать: сказать
да: Да
мол: мол
но: но
вместо: вместо
это: это
из: Из
горло: горлу
вырываться: вырывается
только: только
какойто: какуюто
сиплый: сиплый
хрип: хрип
ты: ты
погодь: погодь
дергаться: дргайся
достаться: Досталось
ребро: Рбра
я: я
перетянуть: перетянул
эффект: эффекту
маловатый: маловато
тут: тут
тугой: тугая
повязка: повязка
нужный: нужна
где: где
ж: ж
ее: е
взятьто: взятьто
драный: драного
тельник: тельника
бинт: бинт
получаться: получается
дерьмо: дерьма
пуля: пуля
уж: уж
простить: прости
сделать: сделал
пока: пока
нака: нака
хлебнуть: хлебни
питьто: питьто
поди: поди
хотеться: хочется
ято: ято
знать: знает
сюжет: сюжета
следующий: следующий
короткий: короткий
прихрамывать: прихрамывая
бежать: бежать
овраг: оврагу
он: он
удаться: удалось
усыпить: усыпить
бдительность: бдительность
охранник: охранника
смыться: смыться
незамеченный: незамеченным
очень: очень
недолго: недолго
догнать: Догнали
бить: бьт
долго: долго
сильно: сильно
странный: странно
пристрелить: пристрелили
вернуть: вернули
обратно: обратно
капитан: Капитан
демьяненко: Демьяненко
делиться: делился
патрон: патронами
ухаживать: ухаживал
за: за
избить: избитым
вообще: вообще
давать: давал
ум: ума
сойти: сойти
посетовать: посетовал
бегать: бегает
разве: разве
одиночка: одиночку
делать: делают
еще: ещ
подготовка: подготовка
свой: сво
бросать: бросать
нехорошо: нехорошо
правый: прав
пиджак: пиджака
ввалить: ввалил
ладно: ладно
значит: значит
готовиться: готовиться
конец: Конец
очередной: Очередная
картинка: картинка
вонючий: вонючая
вилами: вилами
грузить: грузит
навоз: навозе
тачка: тачку
жара: жара
вонь: вонь
такой: такая
хоть: хоть
падать: падает
муха: мухам
рой: роем
вьются: вьются
норовить: норовя
залететь: залететь
рот: рот
приходиться: приходится
дышать: дышать
нос: носом
ноздря: ноздри
казаться: кажутся
даже: даже
привлекательный: привлекательными
яростно: яростно
отмахиваться: отмахивается
помогать: помогает
мало: мало
чернявый: Чернявая
ребятня: ребятня
двор: двором
глядеть: глядя
размахивать: размахивает
рука: рукой
радостно: радостно
гоготать: гогочет
потом: Потом
они: них
опять: опять
становиться: становится
скучный: скучно
чтобы: Чтобы
развеять: развеять
скука: скуку
приниматься: принимаются
кидать: кидать
камень: камень
метко: метко
швыряют: швыряют
сук: суки
один: одна
рассечь: рассечнной
бровь: брови
илюха: Илюха
неожиданность: неожиданности
терять: теряет
равновесие: равновесие
восстановить: восстановить
воткнуть: воткнуть
вилы: вил
земля: земли
дабы: дабы
опереться: опереться
устать: уставшие
соскальзывать: соскальзывают
черенок: черенка
куча: кучу
увлекать: увлекая
зуб: зубом
выворачиваться: выворачиваются
тихий: тихим
хруст: хрустом
обламываться: обламывается
оставаться: остается
торчать: торчать
второй: вторая
точно: точно
кумпол: кумполу
цирк: Цирк
мля: мля
ржать: Ржут
уже: уже
кровища: Кровища
твой: твоего
баран: барана
хлестать: хлещет
говно: говне
плюс: плюс
здоровенный: здоровенный
шишак: шишак
затылок: затылке
смейтесь: Смейтесь
смеяться: смейтесь
барахтаться: барахтался
успетьтаки: успелтаки
вынуть: вынуть
обломать: обломанный
спрятать: спрятать
рукав: рукав
столько: столько
говнищий: говнища
налиплый: налипло
обыскивать: обыскивать
никто: Никто
решиться: решится
снова: Снова
смена: смена
кадр: кадра
поздний: Поздняя
осень: осень
основный: основная
часть: часть
боевик: боевиков
покинуть: покинула
деревня: деревне
похоже: похоже
планировать: планируют
операция: операцию
какой: какие
бы: бы
б: б
сообщить: сообщили
важный: важно
охрана: охрану
остаться: осталась
минимум: минимум
пленный: пленных
лишь: лишь
остальной: остальные
свести: свл
счеты: счты
жизнь: жизнью
обменять: обменяли
либо: либо
продать: продали
рабовладелец: рабовладельцы
хреновый: хреновы
надо: Надо
дергать: дргать
отсюда: отсюда
другой: другого
мочь: может
представиться: представиться
подкоп: Подкоп
дальний: дальнем
угол: углу
сарай: сарай
давно: давно
готовый: готов
рукоять: рукоятью
намотать: намотанных
тряпка: тряпок
тоже: тоже
силенка: Силнок
постоянный: постоянный
голод: голод
побои: побои
здоровье: здоровья
добавлять: добавляют
деватьсято: деватьсято
некуда: некуда
небольшой: невелик
пробовать: пробовать
ждать: ждать
копыто: копыта
отбросить: отбросишь
ну: ну
ласт: ластами
щелкнуть: щлкнешь
ни: ни
назвать: назови
результат: результат
ночь: Ночь
часовой: Часовой
мирно: мирно
похрапывать: похрапывает
темнота: темноты
возникать: возникают
два: Две
тень: тени
быстро: быстро
зажимать: зажимает
спать: спал
резко: резко
остро: остро
заточить: заточенным
сердце: сердце
взбрыкнуть: взбрыкнул
напоследок: напоследок
затихнуть: затих
собака: собаки
молчать: молчат
этот: эти
рабовладельцам: рабовладельцам
собственный: собственные
кормить: кормит
лень: лень
свалить: свалили
работа: работы
известный: известно
никогда: никогда
тронуть: тронут
вот: вот
барбосик: барбосики
спасибо: Спасибо
огромный: огромные
лохматый: лохматые
животное: животные
способный: способные
противостоять: противостоять
стая: стае
волк: волков
оказаться: оказались
намного: намного
человечнее: человечнее
хозяин: хозяев
подхватывать: подхватывают
труп: труп
пошатываясь: пошатываясь
тащить: тащат
тяжеленный: Тяжеленный
падла: падла
отличие: отличие
вволю: вволю
жрать: жрал
пузо: пуза
утруждаться: утруждался
разоружив: Разоружив
жертва: жертву
подбить: подбили
итог: итоги
автомат: автомату
штука: штука
разгрузка: Разгрузка
четыре: четырьмя
магазин: магазинами
подсоединить: подсоединен
итого: итого
пять: пять
нож: нож
штаны: Штаны
куртка: куртка
ботинок: ботинки
нормально: Нормально
скоро: скоро
запас: запасы
пополниться: пополнятся
убирать: убирать
профи: профи
решить: решил
разобраться: разобраться
домочадец: домочадцами
должный: должен
уцелеть: уцелеть
плевать: Плевать
там: там
женщина: женщины
ребенок: дети
ничто: ничем
сколько: сколько
издевательство: издевательств
вытерпел: вытерпел
счет: счту
сбиться: собьешься
мальчишка: мальчишки
четырнадцать: четырнадцати
пятнадцать: пятнадцати
волчата: волчата
перевоспитывать: перевоспитывать
поздно: поздно
нет: нет
жалость: жалости
грамм: грамма
ненависть: ненависть
человек: люди
зверь: звери
поэтому: поэтому
дрожать: дрожат
совесть: совесть
мучить: мучает
зубец: Зубец
выбросить: выброшен
дело: дело
парень: парень
взять: взял
острый: острый
кухонный: кухонный
большой: больше
подходить: подходит
последующий: последующей
работато: Работато
нехитрый: нехитрая
зажать: зажал
полоснуть: полоснул
главный: главных
шуметь: шуметь
представлять: Представляем
внимание: вниманию
похожий: похожие
отобрать: отобрали
схожий: схожую
название: названию
смысл: смысле
литература: литературу
надежда: надежде
предоставить: предоставить
читатель: читателей
больше: больше
вариант: вариантов
интересный: интересные
обсуждение: Обсуждение
просто: просто
мнение: мнения
оставить: Оставьте
думать: думаете
указать: Укажите
конкретно: конкретно
понравиться: понравилось
почему: почему
считать: считаете
