заголовок: Заголовок
олег: Олег
данильченко: Данильченко
имперский: Имперский
вояж: вояж
читать: читать
онлайн: онлайн
бесплатно: бесплатно
адрес: Адрес
здесь: здесь
быть: есть
возможность: Возможность
весь: вс
текст: текст
электронный: электронной
книга: книге
совершенно: совершенно
целиком: целиком
полный: полную
версия: версию
в: в
некоторый: некоторых
случай: случай
присутствовать: присутствует
краткий: краткое
содержание: содержание
город: Город
м: М
спб: СПб
год: год
выпуск: выпуска
издательство: издательство
аста: АСТ
издательский: Издательский
дом: дом
ленинград: Ленинград
категория: категорию
боевой: Боевая
фантастика: фантастика
космический: Космическая
на: на
русский: русском
язык: языке
описание: описание
произведение: произведении
предисловие: предисловие
а: а
так: так
же: же
отзыв: отзывы
посетитель: посетителей
доступный: доступны
портал: портале
библиотека: Библиотека
либ: Либ
кат: Кат
создать: создана
для: для
любитель: любителей
полистать: полистать
хороший: хорошо
книжка: книжку
и: и
предлагать: Предлагаем
широкий: широкий
выбор: выбора
жанр: жанров
любовный: любовные
роман: романы
фэнтези: фэнтези
приключение: приключения
детектив: детективы
триллер: триллеры
эротика: эротика
документальный: документальные
научный: научные
юмористический: юмористические
анекдот: анекдоты
о: о
бизнес: бизнесе
проза: проза
детский: детские
сказка: сказки
религиия: религиии
новинка: новинки
православный: православные
старинный: старинные
про: про
компьютер: компьютеры
программирование: программирование
английский: английском
домоводство: домоводство
поэзия: поэзия
выбрав: Выбрав
по: по
душа: душе
вы: Вы
смочь: сможете
найти: нашли
действительно: действительно
стоить: стоящие
насладиться: насладиться
погружение: погружением
мир: мир
воображение: воображения
прочувствовать: прочувствовать
переживание: переживания
герой: героях
или: или
узнать: Узнайте
себя: себя
чтото: чтото
новый: новые
совершить: совершить
внутренний: внутреннее
открытие: открытие
подробный: Подробная
информация: информацию
ознакомление: ознакомления
текущий: текущему
запрос: запросу
представить: представлен
низкий: Ниже
к: к
чтение: чтение
аннотация: аннотацию
зависеть: зависит
от: от
тот: то
что: что
написать: напишите
сам: сам
автор: автора
если: Если
не: не
необходимый: необходимо
комментарий: комментарии
мы: Мы
постараться: постараемся
отыскать: отыскать
она: е
кто: кого
фамилия: фамилию
как: как
звать: зовут
список: списком
его: его
серия: сериям
уважаемые: Уважаемые
правообладатель: правообладатели
размещать: размещать
наш: наш
сайт: сайте
у: У
любой: любой
зарегистрировать: зарегистрированного
пользователь: пользователя
ваш: ваши
опубликовать: опубликована
без: без
согласие: согласия
пожалуйста: пожалуйста
направить: направьте
жалоба: жалобу
заполните: заполните
форма: форму
обратный: обратной
связь: связи
течение: течение
час: часов
закрыть: закроем
доступ: доступ
нелегально: нелегально
разместить: размещенному
контент: контенту
разбить: разбитый
страница: страницу
система: Система
сохранение: сохранения
место: места
последний: последней
прочитать: прочитанные
позволять: позволяет
с: с
удобство: удобством
необходимость: необходимости
каждый: каждый
раз: раз
заново: заново
искать: искать
остановиться: остановились
поставить: поставили
закладка: Закладка
момент: момент
перейти: перейти
который: которое
закончить: закончишь
шрифт: Шрифт
интервал: Интервал
тут: тут
зал: зал
грохнуть: грохнул
ржать: Ржали
лечь: лг
стол: столом
под: под
кататься: катался
держаться: держась
за: за
живот: живот
док: док
смех: смеха
сползать: сползал
переборка: переборке
испуг: испуге
опереться: оперся
спина: спине
еще: ещ
начало: начале
инцидент: инцидента
самый: самое
главный: главных
этот: этого
шумный: шумный
всеобщий: всеобщий
хохот: хохот
перекрывать: перекрывал
громовой: громовой
бас: бас
смеющегося: смеющегося
джойло: Джойл
я: я
нравиться: нравится
парень: парня
сказать: сказал
он: он
вставать: вставая
грег: Грег
ты: Ты
уверенный: Уверен
чистый: чистый
проверять: проверял
маленький: меньше
удивленный: удивлн
имплант: имплантов
несколько: несколько
миллион: миллионов
кредит: кредитов
повернуться: повернувшись
илья: Илье
баюкать: баюкал
отбить: отбитую
рука: рукой
ну: Ну
молодой: молодой
человек: человека
сегодня: сегодня
удивить: удивили
только: только
давать: Давай
свой: свой
осмотреть: Осмотрев
продолжить: продолжил
да: да
нет: нет
порядок: порядке
просто: просто
сильный: сильный
ушиб: ушиба
но: но
всякий: всякий
вернуться: вернулся
медсекция: медсекцию
пятнадцать: пятнадцати
минута: минут
капсула: капсуле
прийти: придт
норма: норму
ээээ: Ээээ
уже: уже
уводите: уводите
поделать: поделать
проверить: Проверить
надо: надо
можно: можно
дредноуты: дредноуты
сбивать: сбивать
голый: голой
это: это
вина: вина
переживать: переживайте
ненадолго: ненадолго
ладный: Ладно
извинить: извини
радостно: радостно
осклабиться: осклабился
хлопнуть: хлопнул
илюха: Илюха
плечо: плечу
глупый: Глупая
шутка: Шутка
получиться: получилась
молодец: молодец
лечить: лечить
лапа: лапу
подходить: подходи
сюда: сюда
познакомиться: Познакомимся
пообщаться: пообщаемся
надеяться: Надеюсь
против: против
пройти: прошл
обязательный: обязательные
процедура: процедуры
число: числе
медицинский: медицинские
законный: законном
основание: основании
являться: является
официальный: официальным
гость: гостем
империя: Империи
вольный: волен
распоряжаться: распоряжаться
усмотрение: усмотрению
хотеть: хотел
задать: задать
интересовать: интересующие
вопрос: вопросы
думать: думаете
многое: многое
объяснить: объяснить
более: более
много: много
общий: общего
поговорить: поговорить
ведь: Ведь
тоже: тоже
солдат: солдат
хотя: хотя
теперь: теперь
бывший: бывший
попасть: попал
прямик: прямиком
война: войны
принимать: принимайте
компания: компания
ха: Ха
точно: Точно
рявкнуть: рявкнул
бугай: бугай
брат: брат
бегом: бегом
пузырь: пузырь
лада: Лады
почему: почему
бы: бы
пожать: Пожал
ждать: Ждем
глава: Глава
лечение: Лечение
занять: заняло
больше: больше
поэтому: поэтому
когда: когда
столовая: столовую
команда: команды
ажиотаж: ажиотаж
продолжаться: продолжался
народ: народ
прибавиться: прибавилось
обсуждать: обсуждали
произойти: произошедшее
появиться: появилось
даже: даже
сразу: сразу
заметить: заметил
оказаться: оказался
первый: Первым
углядеть: углядел
броуновский: броуновском
движение: движении
прекращаться: прекращалось
помещение: помещении
аааа: Аааа
вот: вот
находка: находка
пока: пока
пробираться: пробирался
где: где
обосноваться: обосновалась
мимо: мимо
проходить: проходил
стараться: старался
както: както
выразить: выразить
расположение: расположение
хлопать: хлопал
показаться: показалось
добраться: доберется
до: до
снова: снова
прийтись: придтся
возвращаться: возвращалась
обойтись: обошлось
никакой: никаких
жизненно: жизненно
важный: важных
часть: частей
тело: тела
лишиться: лишился
зато: Зато
ощущение: ощущение
наконецто: наконецто
настолько: Настолько
происходить: происходящее
данный: данный
вокруг: вокруг
их: их
понятный: понятно
эмоция: эмоциями
напоминать: напоминало
земля: Землю
привычный: привычно
именно: именно
радоваться: радовались
сослуживец: сослуживцы
группа: группа
из: из
рейд: рейда
грудь: груди
защемить: защемило
глаз: глаза
попытаться: попытались
навернуться: навернуться
слезапредатель: слзыпредатели
вспомнить: вспомнил
демьяненко: Демьяненко
похоронить: похороненного
лес: лесу
такой: такой
медицина: медициной
мигом: мигом
нога: ноги
хватать: хватало
сейчас: сейчас
неугасимый: неугасимого
оптимизм: оптимизма
армейский: армейского
грубый: грубого
юмор: юмора
несгибаемый: несгибаемого
воля: воли
жизнь: жизнью
живой: жив
существо: существу
заслуга: заслуга
рядом: рядом
давно: давно
свести: свл
счеты: счты
чувствовать: чувствовал
виноватый: виноватым
перемена: перемену
настроение: настроении
эй: Эй
сделать: сделал
ни: ни
при: при
друг: Друга
вместе: вместе
идти: шли
большой: больше
энди: Энди
командир: командир
раздаться: раздался
приятный: приятный
женский: женский
голос: голос
обратить: обратил
внимание: вниманию
симпатичный: симпатичную
девушка: девушку
огненнорыжий: огненнорыжими
волос: волосами
хвастаться: хвасталась
припрятать: припрятала
кадарский: кадарского
особый: особого
дело: дело
подходящий: подходящий
даватька: Давайка
доставать: доставай
обращаться: обращаясь
пойти: пойдет
нечего: нечего
технарь: технарями
сидеть: сидеть
ребята: ребята
они: им
конечно: конечно
топтун: топтунов
равный: равно
понять: понять
окружать: Окружающий
загалдеть: загалдел
возмущенно: возмущенно
разрядить: разрядил
накал: накал
братва: братва
отходняк: отходняк
начаться: начался
иметь: имейте
совесть: совесть
поскольку: поскольку
служивый: служивый
пехота: пехота
возражение: возражения
представлять: Представляем
похожий: похожие
отобрать: отобрали
схожий: схожую
название: названию
смысл: смысле
литература: литературу
надежда: надежде
предоставить: предоставить
читатель: читателей
вариант: вариантов
интересный: интересные
обсуждение: Обсуждение
собственный: собственные
мнение: мнения
оставить: Оставьте
указать: Укажите
конкретно: конкретно
понравиться: понравилось
считать: считаете
