заголовок: Заголовок
олег: Олег
данильченко: Данильченко
имперский: Имперский
вояж: вояж
читать: читать
онлайн: онлайн
бесплатно: бесплатно
адрес: Адрес
здесь: Здесь
быть: быть
возможность: Возможность
весь: Все
текст: текст
электронный: электронной
книга: книге
совершенно: совершенно
целиком: целиком
полный: полный
версия: версию
в: в
некоторый: некоторых
случай: случаях
присутствовать: присутствует
краткий: краткое
содержание: содержание
город: Город
м: М
спб: СПб
год: год
выпуск: выпуска
издательство: издательство
аста: АСТ
издательский: Издательский
дом: дом
ленинград: Ленинград
категория: категорию
боевой: боевой
фантастика: фантастика
космический: Космическая
на: на
русский: русскому
язык: языке
описание: описание
произведение: произведении
предисловие: предисловие
а: а
так: так
же: же
отзыв: отзывы
посетитель: посетителей
доступный: доступны
портал: портале
библиотека: Библиотека
либ: Либ
кат: Кат
создать: создана
для: для
любитель: любителей
полистать: полистать
хороший: Хорошо
книжка: книжку
и: и
предлагать: Предлагаем
широкий: широкий
выбор: выбора
жанр: жанров
любовный: любовные
роман: романы
фэнтези: фэнтези
приключение: приключения
детектив: детективы
триллер: триллеры
эротика: эротика
документальный: документальные
научный: научные
юмористический: юмористические
анекдот: анекдоты
о: о
бизнес: бизнесе
проза: проза
детский: детские
сказка: сказки
религиия: религиии
новинка: новинки
православный: православные
старинный: старинные
про: про
компьютер: компьютеры
программирование: программирование
английский: английском
домоводство: домоводство
поэзия: поэзия
выбрав: Выбрав
по: по
душа: душе
вы: Вы
смочь: смогли
найти: нашли
действительно: действительно
стоить: стоит
насладиться: насладиться
погружение: погружением
мир: мир
воображение: воображения
прочувствовать: прочувствовать
переживание: переживания
герой: героях
или: или
узнать: Узнайте
себя: собой
чтото: чтото
новый: новые
совершить: совершить
внутренний: внутреннее
открытие: открытие
подробный: Подробная
информация: информацию
ознакомление: ознакомления
текущий: текущему
запрос: запросу
представить: представлен
низкий: Ниже
к: к
чтение: чтение
аннотация: аннотацию
зависеть: зависит
от: от
тот: той
что: что
написать: напишите
сам: сам
автор: автора
если: если
не: не
необходимый: необходимую
комментарий: комментарии
мы: Мы
постараться: постараемся
отыскать: отыскать
она: ей
кто: кто
фамилия: фамилию
как: как
звать: зовут
список: списком
его: его
серия: сериям
уважаемые: Уважаемые
правообладатель: правообладатели
размещать: размещать
наш: наш
сайт: сайте
у: у
любой: любой
зарегистрировать: зарегистрированного
пользователь: пользователя
ваш: ваши
опубликовать: опубликована
без: без
согласие: согласия
пожалуйста: пожалуйста
направить: направленных
жалоба: жалобу
заполните: заполните
форма: форму
обратный: обратной
связь: связи
течение: течение
час: часы
закрыть: закроем
доступ: доступ
нелегально: нелегально
разместить: размещенному
контент: контенту
разбить: разбитый
страница: страницу
система: Система
сохранение: сохранения
место: места
последний: последней
прочитать: прочитанные
позволять: позволяю
с: с
удобство: удобством
необходимость: необходимости
каждый: каждый
раз: разу
заново: заново
искать: искать
остановиться: остановились
поставить: Поставьте
закладка: Закладка
момент: момент
перейти: перейти
который: которой
закончить: закончили
шрифт: Шрифт
интервал: Интервал
лицо: лице
ребята: Ребята
видно: видно
они: них
полностью: полностью
поддерживать: поддерживают
бер: Бер
обидный: обидно
за: за
свой: свою
командир: командира
мгновенно: Мгновенно
забыть: забыты
недавний: недавние
недоразумение: недоразумения
тяжелый: тяжлый
разговор: разговор
сработать: сработало
чувство: чувство
локоть: локтя
появляться: появляется
сплоченный: сплоченной
команда: команда
вот: Вот
теперь: теперь
илюха: Илюху
уверенный: уверен
подвести: подведут
похоже: Похоже
он: его
получиться: получилось
пусть: Пусть
коряво: коряво
некрасивый: некрасиво
но: но
сплотиться: сплотились
единый: единый
организм: организм
отныне: отныне
работать: работают
разве: Разве
изобразить: Изобразил
удивление: удивление
зевран: Зевран
наставник: наставник
загадочный: загадочно
улыбаться: улыбался
давать: давайте
спросить: спросила
думать: думаете
этот: этот
повод: поводу
взор: взоры
вопросительный: вопросительно
уперлись: упрлись
верный: верное
начать: начал
отличный: Отличная
оценка: оценка
действие: действие
это: этому
похвала: похвала
руководитель: руководителя
можно: Можно
сколько: сколько
угодно: угодно
хвалить: хвалил
действовать: действует
неэффективно: неэффективно
то: то
кредит: кредита
нахваливать: нахваливая
уважаемый: уважаемый
оружейный: оружейных
дело: дело
мастер: мастер
я: меня
удивленно: удивлнно
смотреть: смотрели
уже: уже
старый: Старый
хитрован: хитрован
украдкой: украдкой
изза: изза
спина: спины
показывать: показывал
черим: Чериму
кулак: кулак
содружество: Содружества
эквивалентный: эквивалентно
оттопырить: оттопыренным
больший: большим
палец: пальцем
илья: Илья
пока: пока
еще: ещ
адаптироваться: адаптировался
местный: местной
жестикуляция: жестикуляции
поэтому: поэтому
очень: очень
часто: часто
срабатывать: срабатывали
рефлекс: рефлексы
беррана: Беррана
удивиться: удивилась
когда: когда
показать: показал
поощрять: поощряющий
одновременно: одновременно
ругать: ругая
при: при
природа: природы
неглупый: неглупой
понять: поняла
просто: просто
иметь: имел
вид: видом
подать: подала
между: между
другой: другой
помещение: помещении
из: из
высокий: высший
преподавательский: преподавательский
состав: состав
обычно: обычно
следить: следит
ход: ходом
соревнование: соревнования
состояться: состоялся
такой: такого
мочь: может
произойти: произойти
брызгало: брызгал
слюна: слюной
вернуть: Врни
ладно: Ладно
юный: юная
леди: леди
ри: Ри
орь: Ори
пилот: пилот
опыт: опыт
преподавание: преподавания
выто: выто
чем: чем
капитан: капитан
медленно: медленно
оглядеть: оглядел
троица: троицу
состоять: состоящую
лазго: Лазго
руно: Рун
годзь: Годзи
надбавка: надбавки
постоянно: постоянно
выбивать: выбиваю
отбирать: отбирать
группа: группы
человек: людей
чтобы: чтобы
какойто: какойто
дикарь: дикарь
глава: главе
некомплектный: некомплектной
нищий: нищих
оборванец: оборванцев
отделал: отделал
полигон: полигоне
ребенок: детей
простите: Простите
господин: господином
осмелиться: осмелился
возразить: возразить
никто: никто
ожидать: ожидал
парень: парня
прыть: прыти
только: только
запросить: запросил
архив: архива
личный: личное
оказываться: Оказывается
реальный: реальный
правда: Правда
воевать: воевал
родина: родине
однако: Однако
наземный: наземных
операция: операций
много: много
значить: значащий
легко: легко
адоптировать: адоптировать
под: под
вооружение: вооружение
держать: держите
идиот: идиота
взвиться: Взвился
удивить: удивить
сведение: сведению
знать: знал
первый: первого
день: дня
вопрос: Вопрос
почему: почему
бал: Балах
выиграть: выиграла
после: после
оглушительный: оглушительного
разгром: разгрома
озаботиться: озаботились
выяснение: выяснением
причина: причин
подумать: Подумай
ранний: раньше
бы: бы
более: более
грамотно: грамотно
спланировать: спланировать
подопечный: подопечных
виноватый: виновато
молчать: молчал
старик: старика
веселиться: веселился
вместе: вместе
наблюдать: наблюдала
вдруг: вдруг
элентийка: элентийка
скучающий: скучающим
разглядывать: разглядывала
безупречно: безупречно
блестящий: блестящие
ноготь: ногти
выискивать: выискивая
один: одной
заметный: заметные
изъян: изъяны
внимание: вниманию
мастероружейник: мастероружейник
махнуть: махнул
рука: руку
ничто: ничего
пенсионер: пенсионер
принимать: принимал
работа: работой
полномочие: полномочия
слово: слову
сказать: сказать
вполне: вполне
справляться: справляется
стать: стала
сбрасывать: сбрасывать
счет: счетов
выражение: Выражение
гордость: гордости
явно: явно
читаться: читалось
тоже: тоже
приложить: приложил
сегодняшний: сегодняшним
событие: событиям
считать: считаете
почти: Почти
уверить: уверена
вряд: Вряд
ли: ли
хватить: хватило
мозг: мозги
провернуть: провернуть
одиночка: одиночку
проверить: проверю
насчет: насчт
позволить: позволил
согласиться: согласиться
обратить: обратили
быстро: быстро
сориентироваться: сориентировался
ситуация: ситуации
девушка: Девушка
поднять: подняла
красивый: красивую
бровь: бровь
ведь: ведь
нарушить: нарушил
правило: правила
предупредить: предупредить
засадный: засадной
тактика: тактике
благодаря: благодаря
удаться: удалось
потеря: потерь
уничтожить: уничтожить
предыдущий: предыдущего
противник: противника
именно: именно
попасть: попала
взрыв: взрывов
характерный: характерно
до: до
сей: сих
пора: пор
ни: ни
делать: делал
предпочитать: предпочитают
контактный: контактный
бой: бой
наоборот: наоборот
принять: принял
единственно: единственно
решение: решение
жертвовать: жертвуя
нееет: Нееет
приличный: прилично
отличие: отличие
уж: уж
извинить: извините
ре: Ре
там: там
пил: Пиле
казаться: кажется
дурак: дурак
представлять: Представляем
похожий: похожие
отобрать: отобрали
схожий: схожую
название: названию
смысл: смысле
литература: литературу
надежда: надежде
предоставить: предоставить
читатель: читателей
больше: больше
вариант: вариантов
интересный: интересные
обсуждение: Обсуждение
собственный: собственные
мнение: мнения
оставить: Оставьте
главный: главных
указать: Укажите
конкретно: конкретно
понравиться: понравилось
нет: нет
