заголовок: Заголовок
олег: Олег
данильченко: Данильченко
имперский: Имперский
вояж: вояж
читать: читать
онлайн: онлайн
бесплатно: бесплатно
адрес: Адрес
здесь: Здесь
быть: будет
возможность: Возможность
весь: всей
текст: текст
электронный: электронной
книга: книге
совершенно: совершенно
целиком: целиком
полный: полную
версия: версию
в: в
некоторый: некоторых
случай: случаях
присутствовать: присутствовали
краткий: краткое
содержание: содержание
город: Город
м: М
спб: СПб
год: годах
выпуск: выпуска
издательство: издательство
аста: АСТ
издательский: Издательский
дом: дом
ленинград: Ленинград
категория: категорию
боевой: Боевая
фантастика: фантастика
космический: Космическая
на: на
русский: русском
язык: языке
описание: описание
произведение: произведении
предисловие: предисловие
а: а
так: так
же: же
отзыв: отзывы
посетитель: посетителей
доступный: доступны
портал: портале
библиотека: Библиотека
либ: Либ
кат: Кат
создать: создана
для: для
любитель: любителей
полистать: полистать
хороший: лучших
книжка: книжку
и: и
предлагать: Предлагаем
широкий: широкий
выбор: выбора
жанр: жанров
любовный: любовные
роман: романы
фэнтези: фэнтези
приключение: приключения
детектив: детективы
триллер: триллеры
эротика: эротика
документальный: документальные
научный: научные
юмористический: юмористические
анекдот: анекдоты
о: о
бизнес: бизнесе
проза: проза
детский: детские
сказка: сказки
религиия: религиии
новинка: новинки
православный: православные
старинный: старинные
про: про
компьютер: компьютеры
программирование: программирование
английский: английском
домоводство: домоводство
поэзия: поэзия
выбрав: Выбрав
по: по
душа: душе
вы: Вы
смочь: смогут
найти: нашли
действительно: действительно
стоить: стоящие
насладиться: насладиться
погружение: погружением
мир: мир
воображение: воображения
прочувствовать: прочувствовать
переживание: переживания
герой: героях
или: или
узнать: Узнайте
себя: себе
чтото: чтото
новый: новые
совершить: совершить
внутренний: внутреннее
открытие: открытие
подробный: Подробная
информация: информацию
ознакомление: ознакомления
текущий: текущему
запрос: запросу
представить: представить
низкий: Ниже
к: к
чтение: чтение
аннотация: аннотацию
зависеть: зависит
от: от
тот: то
что: что
написать: напишите
сам: сам
автор: автора
если: Если
не: не
необходимый: необходимую
комментарий: комментарии
мы: Мы
постараться: постараемся
отыскать: отыскать
она: ей
кто: кого
фамилия: фамилию
как: как
звать: зовут
список: списком
его: его
серия: сериям
уважаемые: Уважаемые
правообладатель: правообладатели
размещать: размещать
наш: наш
сайт: сайте
у: у
любой: любой
зарегистрировать: зарегистрированного
пользователь: пользователя
ваш: ваши
опубликовать: опубликована
без: без
согласие: согласия
пожалуйста: пожалуйста
направить: направьте
жалоба: жалобу
заполните: заполните
форма: Форма
обратный: обратной
связь: связи
течение: течение
час: часов
закрыть: закроем
доступ: доступ
нелегально: нелегально
разместить: размещенному
контент: контенту
разбить: разбитый
страница: страницу
система: Система
сохранение: сохранения
место: место
последний: последняя
прочитать: прочитанные
позволять: позволяет
с: с
удобство: удобством
необходимость: необходимости
каждый: каждый
раз: раз
заново: заново
искать: искать
остановиться: остановились
поставить: Поставьте
закладка: Закладка
момент: момента
перейти: перейти
который: который
закончить: Закончив
шрифт: Шрифт
интервал: Интервал
торжественный: торжественной
часть: часть
начальство: начальство
важный: важно
удалиться: удалилось
курсант: курсант
оказаться: оказался
цепкий: цепких
лапка: лапках
свой: своей
командир: командиров
куууурс: Куууурс
внимание: вниманию
организованно: Организованно
двигаться: движемся
за: за
я: Я
брифингзал: Брифингзал
гаркнуть: гаркнул
уже: уже
знакомый: знакомый
илюха: Илюха
капитан: капитан
направиться: направился
близкий: ближайшему
выход: выходу
нестройной: нестройной
колонна: колонной
потянуться: потянулись
вслед: вслед
пустой: пуст
там: там
пять: пяти
человек: человеком
звание: звание
флаглейтенат: флаглейтената
четверо: Четверо
мужчина: мужчина
трое: трое
из: из
приблизительно: приблизительно
один: одного
возраст: возраста
вид: вид
тридцать: тридцати
точный: точнее
сказать: сказал
пролонг: пролонга
давать: дат
стареть: стареть
четвертый: Четвертый
пожилой: пожилой
даже: даже
видимо: Видимо
процедура: процедура
давно: давно
плечо: плечами
этот: этого
выглядеть: выглядел
както: както
уныло: уныло
ли: ли
однако: Однако
орденский: орденские
нашивка: нашивки
являть: являли
внушительный: внушительный
иконостас: иконостас
вот: вот
пятый: пятого
персонаж: персонаж
поразить: поразила
правильнее: правильнее
мужской: Мужская
восхищенно: восхищенно
раззявила: раззявила
пасть: пасти
пускать: пуская
слюни: слюни
экстаз: экстазе
женский: женская
неприязненный: неприязненно
злобно: злобно
сверлить: сверлили
взгляд: взглядов
восхитительновеликолепный: восхитительновеликолепную
фигура: фигуру
лицо: лице
молодой: молодой
женщина: женщиной
элента: эленте
непроизвольно: непроизвольно
пустить: пустил
красивый: красивая
причем: причем
слово: слово
красота: красота
казаться: казалось
слишком: слишком
тусклый: тусклым
фон: фоне
безупречный: безупречной
внешность: внешность
элентийка: элентийкой
сидеть: сидела
второй: втором
кожа: кожа
облегать: облегая
соблазнительный: соблазнительные
изгиб: изгибы
единый: единой
морщинка: морщинки
единственный: Единственное
портить: портило
прекрасный: прекрасную
брюнетка: брюнетку
это: это
холоднонадменный: холоднонадменное
выражение: выражению
идеальный: идеальном
устыдившись: Устыдившись
такой: таких
реакция: реакции
почувствовать: почувствовав
предатель: предателем
отношение: отношению
энди: Энди
илья: Илья
изобразить: изобразил
безразличноскучающий: безразличноскучающий
тип: Типа
ну: Ну
подумаешь: подумаешь
видать: видали
поход: Походу
он: он
удаться: удалось
потому: потому
заинтересованно: заинтересованно
начать: начнм
разглядывать: разглядывать
землянин: землянина
непривычный: непривычно
когда: Когда
ее: е
реагировать: реагируют
темный: тмных
глаз: глаз
недобрый: недобрым
но: но
спокойно: спокойно
выдержать: выдержал
оставаться: оставаться
делать: делать
тут: Тут
закусить: закусило
опускать: опускать
трусливо: трусливо
око: очи
дол: долу
перед: передо
пусть: пусть
заведомо: заведомо
считать: считаете
ты: ты
наподобие: наподобие
слизняк: слизняка
хрен: хрен
угадала: угадала
лярва: лярва
вокзальный: вокзальная
подумать: подумал
также: также
демонстративно: демонстративно
вызывающенагло: вызывающенагло
разглядывая: разглядывая
стерва: стерву
поиграть: Поиграв
гляделка: гляделки
незнакомка: незнакомка
подойти: подошла
спросить: спросила
указать: Укажите
ответить: ответил
после: после
девушка: девушки
добавиться: добавилась
еще: ещ
брезгливость: брезгливость
можно: можно
более: более
издевательский: издевательской
ухмылка: ухмылкой
дуэль: дуэль
прекратиться: прекратилась
длиться: длилось
буквально: буквально
пара: пару
минута: минут
никто: Никто
ничто: ничего
заметить: заметил
бы: бы
особа: особа
полностью: полностью
завладеть: завладела
общий: общим
только: только
понять: понял
нажить: нажил
враг: врага
просить: Прошу
садиться: садиться
указывать: указывая
рука: рукой
ряд: ряды
стул: стульев
снимать: снимая
самый: самое
наваждение: наваждение
навеянное: навеянное
опомниться: опомнились
подобрать: подобрали
челюсть: челюсти
приняться: принялись
суетливо: суетливо
занимать: занимает
рассесться: расселись
продолжить: продолжил
обучение: обучение
состоять: состоять
этап: этапа
первый: Первый
кропотливый: кропотливое
изучение: изучение
база: баз
профиль: профилю
физический: физическая
подготовка: подготовка
основа: основы
ведение: ведения
пехотный: пехотного
бой: боя
сюда: Сюда
входить: входят
оружейный: оружейный
минимум: минимум
рукопашный: рукопашного
разуметься: Разумеется
свободный: свободное
время: время
мочь: может
факультативно: факультативно
изучать: изучать
посещать: посещать
занятие: занятия
являться: являющиеся
профильный: профильных
нравиться: нравится
приветствоваться: приветствуется
повторять: повторяю
сдать: сдать
тест: тесты
обязательный: обязательным
дисциплина: дисциплинам
то: то
непрофильный: непрофильные
знание: знаниям
зачет: зачт
идти: идут
страх: страх
риск: риск
следовать: следующих
ранг: рангу
практический: практическое
закрепление: закрепление
изучить: изученных
пилотирование: пилотирования
навигация: навигации
швартовка: швартовка
аварийный: аварийные
ситуация: ситуации
виртуальный: виртуальных
тренажер: тренажерах
реальный: реальных
условие: условиях
третий: Третий
лишь: лишь
разница: разницей
тренировать: тренировать
навык: навыки
усвоить: усвоенные
далее: далее
завершение: завершении
получить: получите
соответствующий: соответствующее
успеть: успеете
подтвердить: подтвердить
чем: Чем
выше: выше
скорость: скорость
тем: тем
большой: больше
стараться: старайтесь
интерес: интересах
теперь: Теперь
хотеть: Хочу
наставник: наставнику
говориться: говорилось
курс: курс
разделить: разделен
группа: группа
подчиняться: подчиняться
очередь: очередь
отчитываться: отчитываться
успех: успехи
неудача: неудачи
сразу: сразу
предупредить: предупредил
невзирая: невзирая
платить: платите
окончить: окончить
школа: школу
далеко: далеко
средний: Средний
показатель: показатель
обычно: обычно
равняться: равняется
восемьдесят: восьмидесяти
процент: процентам
первоначальный: первоначального
количество: количества
собираться: собирается
тянуть: тянуть
ухо: уши
до: до
задача: задача
подготовить: подготовить
высокопрофессиональный: высокопрофессиональных
специалист: специалистов
дорожить: дорожим
репутация: репутацией
центр: центр
право: праву
десяток: десятке
территория: территории
содружество: Содружества
вольный: волен
решать: решать
поступить: поступить
представлять: Представляем
похожий: похожие
отобрать: отобрали
схожий: схожую
название: названию
смысл: смысле
литература: литературу
надежда: надежде
предоставить: предоставить
читатель: читателей
больше: больше
вариант: вариантов
интересный: интересные
обсуждение: Обсуждение
просто: просто
собственный: собственные
мнение: мнения
оставить: Оставьте
думать: думаете
главный: главных
конкретно: конкретно
понравиться: понравилось
нет: нет
почему: почему
