заголовок: Заголовок
олег: Олег
данильченко: Данильченко
имперский: Имперский
вояж: вояж
читать: читать
онлайн: онлайн
бесплатно: бесплатно
адрес: Адрес
здесь: Здесь
быть: будешь
возможность: Возможность
весь: все
текст: текст
электронный: электронной
книга: книге
совершенно: совершенно
целиком: целиком
полный: полной
версия: версию
в: в
некоторый: некоторых
случай: случаях
присутствовать: присутствует
краткий: краткое
содержание: содержание
город: Город
м: М
спб: СПб
год: год
выпуск: выпуска
издательство: издательство
аста: АСТ
издательский: Издательский
дом: дом
ленинград: Ленинград
категория: категорию
боевой: Боевая
фантастика: фантастика
космический: Космическая
на: на
русский: русском
язык: языке
описание: описание
произведение: произведении
предисловие: предисловие
а: а
так: так
же: же
отзыв: отзывы
посетитель: посетителей
доступный: доступны
портал: портале
библиотека: Библиотека
либ: Либ
кат: Кат
создать: создана
для: для
любитель: любителей
полистать: полистать
хороший: хорошем
книжка: книжку
и: и
предлагать: Предлагаем
широкий: широкий
выбор: выбора
жанр: жанров
любовный: любовные
роман: романы
фэнтези: фэнтези
приключение: приключения
детектив: детективы
триллер: триллеры
эротика: эротика
документальный: документальные
научный: научные
юмористический: юмористические
анекдот: анекдоты
о: о
бизнес: бизнесе
проза: проза
детский: детские
сказка: сказки
религиия: религиии
новинка: новинки
православный: православные
старинный: старинные
про: про
компьютер: компьютеры
программирование: программирование
английский: английском
домоводство: домоводство
поэзия: поэзия
выбрав: Выбрав
по: по
душа: душе
вы: Вы
смочь: смогут
найти: нашли
действительно: Действительно
стоить: стоящие
насладиться: насладиться
погружение: погружением
мир: мир
воображение: воображения
прочувствовать: прочувствовать
переживание: переживания
герой: героях
или: или
узнать: Узнайте
себя: себя
чтото: чтото
новый: новые
совершить: совершить
внутренний: внутреннее
открытие: открытие
подробный: Подробная
информация: информацию
ознакомление: ознакомления
текущий: текущему
запрос: запросу
представить: представлен
низкий: Ниже
к: к
чтение: чтение
аннотация: аннотацию
зависеть: зависит
от: от
тот: тем
что: что
написать: напишите
сам: сам
автор: автора
если: если
не: не
необходимый: необходимую
комментарий: комментарии
мы: Мы
постараться: постараемся
отыскать: отыскать
она: она
кто: кто
фамилия: фамилию
как: Как
звать: зовут
список: списком
его: его
серия: сериям
уважаемые: Уважаемые
правообладатель: правообладатели
размещать: размещать
наш: наше
сайт: сайте
у: у
любой: любые
зарегистрировать: зарегистрированного
пользователь: пользователя
ваш: ваши
опубликовать: опубликована
без: без
согласие: согласия
пожалуйста: Пожалуйста
направить: направьте
жалоба: жалобу
заполните: заполните
форма: форме
обратный: обратной
связь: связи
течение: течение
час: часа
закрыть: закроем
доступ: доступ
нелегально: нелегально
разместить: размещенному
контент: контенту
разбить: разбитый
страница: страницу
система: Система
сохранение: сохранения
место: места
последний: последнее
прочитать: прочитанные
позволять: позволяет
с: с
удобство: удобством
необходимость: необходимости
каждый: каждый
раз: раз
заново: заново
искать: искать
остановиться: остановились
поставить: Поставьте
закладка: Закладка
момент: момент
перейти: перейти
который: которые
закончить: закончили
шрифт: Шрифт
интервал: Интервал
я: меня
должный: должен
заметить: заметить
удивиться: удивился
илья: Илья
аааа: Аааа
ну: Ну
да: ДА
время: время
забывать: забываю
эмигрант: эмигрант
никогда: никогда
иметь: имеет
нейросеть: нейросети
сосредоточьтесь: Сосредоточьтесь
периферия: периферии
зрение: зрения
мигать: мигающий
иконка: иконку
вид: виде
шестерня: шестерни
видеть: вижу
часто: часто
тереть: трете
правый: правый
глаз: глаз
моргаете: моргаете
бы: бы
туда: туда
попасть: попала
соринка: соринкой
это: это
первый: первое
симптом: симптом
после: после
активация: активации
еще: ещ
привычка: привычки
полчаса: полчаса
илюха: Илюха
никак: никак
мочь: Может
справиться: справятся
этот: этом
навязчивый: навязчивой
оказываться: оказывается
он: он
попробовать: попробовал
сделать: сделать
сказать: сказала
няга: Нягу
точно: точно
увидеть: увидел
желтый: жлтый
значок: значок
только: только
сосредоточиться: сосредоточился
нем: нм
развернуться: развернулся
больший: большую
надпись: надпись
установить: установили
готовый: готов
работа: работе
активировать: Активировал
нет: нет
начать: начала
вращаться: вращающуюся
до: до
два: два
подождать: подождать
всплыть: Всплыла
следующий: следующие
исчезнуть: исчезла
оставить: Оставьте
сеть: сеть
просить: Просит
резюмировать: резюмировал
свой: своим
действие: действия
надевать: надевая
стать: стал
уже: уже
родный: родным
комбез: комбез
принести: принесли
вместе: вместе
свежий: свежим
белье: бельм
обувь: обувью
вот: Вот
прекрасно: прекрасно
пока: пока
происходить: происходит
сообщить: сообщите
номер: номер
счет: счета
чтобы: чтобы
перевести: перевел
оговорить: оговоренные
деньга: деньги
пойти: пойдм
выбрать: выберете
база: базе
знание: знаний
посчитать: посчитаете
нужный: нужно
предупреждать: Предупреждаю
выбирать: выбирали
внимательно: внимательно
иначе: иначе
взять: возьмете
чтонибудь: чтонибудь
возврат: возврату
подлежать: подлежать
достать: достал
из: из
карман: кармана
карточка: карточку
зачитать: зачитал
насчет: насчт
поступить: поступлю
образ: образом
сначала: сначала
обучение: обучению
там: там
узнавать: узнаю
понадобиться: понадобится
резерв: резерва
ведь: ведь
предоставить: предоставить
надо: надо
оплачивать: оплачиваю
они: они
поискать: поищу
повезти: повезт
ничто: ничего
сэкономить: Сэкономите
тогда: тогда
хохотнуть: хохотнул
грустно: грустно
вздохнуть: вздохнул
однако: Однако
подсказывать: подсказывает
ободрать: обдерте
голый: голой
задница: задницы
умолять: умоляю
уважаемый: уважаемый
расплыться: расплылся
довольный: довольной
улыбка: улыбке
мой: мою
расчет: расчтам
думать: думаете
через: через
смеяться: смеяться
над: над
кроха: крохами
кровь: кровью
вырвать: вырвал
жадный: жадных
лапка: лапок
поэтому: Поэтому
прибедняться: прибедняйтесь
наладиться: наладится
наглец: Наглец
улыбнуться: улыбнулся
ученый: учным
ладно: Ладно
теперь: теперь
прежде: прежде
чем: чем
наконец: наконец
покинуть: покинете
просьба: просьба
месяц: месяц
давать: давайте
задание: задание
отслеживать: отслеживать
архивировать: архивировать
показание: показания
состояние: состоянию
организм: организма
стандартный: стандартная
функция: функция
потом: потом
отправлять: отправляйте
файл: файл
затруднить: затруднит
заключительный: заключительных
шаг: шагов
исследование: исследовании
марш: марш
отсюда: отсюда
очаровательный: очаровательная
рыжий: рыжий
сержантша: сержантша
гороподобный: гороподобным
братец: братцем
разнести: разнесли
заведение: заведение
мелкий: мелкие
кусочек: кусочки
нее: не
статься: станется
подтвердить: подтвердил
поспешить: поспешил
встреча: встречу
любимый: любимой
глава: Глава
илио: Илио
раздаться: раздался
надрыв: надрывом
знакомый: знакомый
женский: женский
голос: голос
услышать: услышал
спуститься: спустившись
фойе: фойе
наверное: наверное
десять: десять
минута: минут
потому: Потому
сразу: сразу
налететь: налетел
ураган: ураган
повиснуть: повис
шея: шею
одновременно: одновременно
умудряясь: умудряясь
успевать: успевать
стучать: стучит
кулачок: кулачками
грудь: грудь
обвинять: обвинять
смертный: смертных
грех: грехах
интересный: интересные
восхититься: восхитился
держаться: держится
за: за
то: то
удивительный: Удивительная
женщина: женщина
когда: Когда
эмоция: эмоции
несколько: несколько
улеглись: улеглись
сжатый: сжатой
рассказать: расскажет
задержка: задержка
получиться: получилась
изза: изза
особенность: особенностей
прийтись: пришлось
проваляться: проваляться
пара: пару
день: дней
медкапсула: медкапсуле
помнить: Помня
договор: договоре
распространяться: распространяться
эксперимент: эксперимента
прийти: Придт
мешать: мешало
поесть: поедим
вопрос: вопросы
джойло: Джойл
повод: поводу
дополнительный: дополнительного
имплантат: имплантата
интеллект: интеллект
ответить: ответил
надобность: надобности
хватать: хватает
мол: мол
эмиграционный: эмиграционном
центр: центре
напутать: напутал
медик: медик
очень: очень
хотеться: хочется
энди: Энди
сейчас: Сейчас
но: Но
магазин: магазинам
ты: ты
ходить: ходить
комбинезон: комбинезоне
дело: дело
опешить: опешил
удобный: удобная
одежда: одежда
позорище: Позорище
хотеть: хочешь
тыкать: тыкали
палец: пальцем
возмутиться: возмутилась
девушка: девушка
неслыханный: неслыханно
находиться: находимся
планета: планете
метрополия: Метрополии
метро: МЕТРО
поль: ПОЛИ
комбезе: комбезе
срочно: срочно
исправлять: исправлять
вздумать: вздумай
возражать: возражать
общий: общем
небольшой: небольшого
ресторанчик: ресторанчика
где: где
съесть: съел
огромный: огромный
кусок: кусок
натуральный: натурального
вкусный: вкусного
мясо: мяса
потащить: потащили
правда: Правда
трусливо: трусливо
ретироваться: ретировался
отмазаться: Отмазался
практически: практически
решить: решили
ехать: ехать
представлять: Представляем
внимание: вниманию
похожий: похожие
отобрать: отобрали
схожий: схожую
название: названию
смысл: смысле
литература: литературу
надежда: надежде
читатель: читателей
больше: больше
вариант: вариантов
обсуждение: Обсуждение
просто: просто
собственный: собственные
мнение: мнения
главный: главных
указать: Укажите
конкретно: конкретно
понравиться: понравилось
почему: почему
считать: считаете
