заголовок: Заголовок
олег: Олег
данильченко: Данильченко
имперский: Имперский
вояж: вояж
читать: читать
онлайн: онлайн
бесплатно: бесплатно
адрес: Адрес
здесь: Здесь
быть: будет
возможность: Возможность
весь: все
текст: текст
электронный: электронной
книга: книге
совершенно: совершенно
целиком: целиком
полный: полной
версия: версию
в: в
некоторый: некоторых
случай: случаях
присутствовать: присутствует
краткий: краткое
содержание: содержание
город: Город
м: М
спб: СПб
год: год
выпуск: выпуска
издательство: издательство
аста: АСТ
издательский: Издательский
дом: дом
ленинград: Ленинград
категория: категорию
боевой: Боевая
фантастика: фантастика
космический: Космическая
на: на
русский: русском
язык: языка
описание: описание
произведение: произведении
предисловие: предисловие
а: а
так: так
же: же
отзыв: отзывы
посетитель: посетителей
доступный: доступны
портал: портале
библиотека: Библиотека
либ: Либ
кат: Кат
создать: создана
для: для
любитель: любителей
полистать: полистать
хороший: хорошо
книжка: книжку
и: и
предлагать: Предлагаем
широкий: широкий
выбор: выбора
жанр: жанров
любовный: любовные
роман: романы
фэнтези: фэнтези
приключение: приключения
детектив: детективы
триллер: триллеры
эротика: эротика
документальный: документальные
научный: научные
юмористический: юмористические
анекдот: анекдоты
о: о
бизнес: бизнесе
проза: проза
детский: детские
сказка: сказки
религиия: религиии
новинка: новинки
православный: православные
старинный: старинные
про: про
компьютер: компьютеры
программирование: программирование
английский: английском
домоводство: домоводство
поэзия: поэзия
выбрав: Выбрав
по: по
душа: душе
вы: Вы
смочь: сможете
найти: найти
действительно: действительно
стоить: стоящие
насладиться: насладиться
погружение: погружением
мир: мира
воображение: воображения
прочувствовать: прочувствовать
переживание: переживания
герой: героях
или: или
узнать: Узнайте
себя: себе
чтото: чтото
новый: новые
совершить: совершить
внутренний: внутреннее
открытие: открытие
подробный: Подробная
информация: информацию
ознакомление: ознакомления
текущий: текущему
запрос: запросу
представить: представлен
низкий: Ниже
к: к
чтение: чтение
аннотация: аннотацию
зависеть: зависит
от: от
тот: тот
что: что
написать: напишите
сам: само
автор: автора
если: Если
не: не
необходимый: необходимую
комментарий: комментарии
мы: Мы
постараться: постараемся
отыскать: отыскать
она: она
кто: кто
фамилия: фамилию
как: как
звать: зовут
список: списком
его: его
серия: сериям
уважаемые: Уважаемые
правообладатель: правообладатели
размещать: размещать
наш: нашем
сайт: сайте
у: у
любой: любой
зарегистрировать: зарегистрированного
пользователь: пользователя
ваш: ваши
опубликовать: опубликована
без: без
согласие: согласия
пожалуйста: пожалуйста
направить: направьте
жалоба: жалобу
заполните: заполните
форма: форму
обратный: обратной
связь: связи
течение: течение
час: часов
закрыть: закроем
доступ: доступ
нелегально: нелегально
разместить: размещенному
контент: контенту
разбить: разбитый
страница: страницу
система: Система
сохранение: сохранения
место: места
последний: последней
прочитать: прочитанные
позволять: позволяет
с: с
удобство: удобством
необходимость: необходимости
каждый: каждый
раз: раз
заново: заново
искать: искать
остановиться: остановились
поставить: Поставьте
закладка: Закладка
момент: момент
перейти: перейти
который: которой
закончить: закончили
шрифт: Шрифт
интервал: Интервал
лысый: лысый
молчать: молчал
продолжать: продолжал
сверлить: сверлить
злобный: злобным
взгляд: взглядом
илюха: Илюха
наверно: наверно
наконецтаки: наконецтаки
дойти: дошло
далекий: дальше
общаться: общаться
это: этим
дохлый: дохлый
номер: номер
поразмышляв: Поразмышляв
минута: минут
мужик: мужик
закатить: закатил
глаз: глаза
будто: будто
под: под
свод: сводами
собственный: собственные
череп: черепе
пытаться: пытался
ответ: ответ
интересовать: интересующие
вопрос: вопросы
еще: ещ
через: Через
пара: пару
тихий: тихим
шелест: шелестом
незаметный: незаметная
дверь: дверью
скользнуть: скользнула
вбок: вбок
комната: комнате
войти: вошедшего
другой: другой
персонаж: персонаж
менее: менее
колоритный: колоритный
чем: чем
первый: первого
рост: Ростом
весьма: весьма
поболее: поболее
этак: этак
метр: метр
восемьдесят: восемьдесят
потянуть: потянет
да: Да
сложение: сложением
серьезно: серьзно
покрепче: покрепче
одетый: Одет
он: его
однотипный: однотипно
разница: Разница
заключаться: заключалась
отличие: отличие
голова: голова
число: числе
лицо: лицо
шея: шея
мочь: могут
ниже: ниже
комбез: комбезом
видно: видно
покрыть: покрыты
разноцветный: Разноцветный
татуировка: татуировками
плюс: Плюс
вроде: вроде
кейс: кейс
правый: правой
рука: руки
казаться: Кажись
местный: местным
палач: палач
пожаловать: пожаловал
отрешенный: отрешнно
подумать: подумал
илья: Илью
но: Но
нет: нет
открыть: открыл
извлечь: извлек
оттуда: оттуда
какойто: какуюто
приспособа: приспособу
оказаться: оказалось
ручной: ручной
инъектор: Инъектор
ткнуться: ткнулся
плечо: плечо
коротко: коротко
пшикнуть: пшикнув
секунда: секунду
почувствовать: почувствовал
тело: телу
разливаться: разливается
приятный: приятная
истома: истома
колено: колено
перестать: перестало
дергать: дргать
боль: боль
практически: практически
пройти: прошла
стать: стало
както: както
радостно: радостно
захотеться: захотелось
говорить: говорить
при: При
прекрасно: прекрасно
понимать: понимает
таковой: такового
одурманивание: одурманивания
цветной: цветной
кивнуть: кивнул
просто: просто
лысому: лысому
мол: мол
порядок: порядке
можно: можно
начинать: начинает
затараторить: затараторил
обращаться: обращаясь
уверенность: уверенности
уж: уж
сейчасто: сейчасто
точно: точно
должный: должен
выболтать: выболтать
тайна: тайны
тоже: тоже
совсем: совсем
против: против
ранний: раньше
отказываться: отказывался
отвечать: отвечать
теперь: теперь
аналог: аналогом
сыворотка: сыворотки
правда: правды
более: более
знать: знаю
бы: бы
они: им
ответить: ответил
ситуация: Ситуация
показаться: показаться
комичный: комичной
помножить: помноженное
состояние: состояние
эйфория: эйфории
дать: дало
вполне: вполне
предсказуемый: предсказуемый
эффект: эффект
заржать: заржал
сладкий: сладкая
парочка: парочка
смотреть: смотрела
квадратный: квадратными
удивление: удивления
морда: мордах
эй: Эй
гуманоиды: гуманоиды
че: ч
такой: такой
тупой: тупые
хрен: Хрен
ли: ли
я: я
химия: химия
гуманоид: Гуманоиды
переглянуться: переглянулись
залопотать: залопотали
уже: уже
между: между
размахивать: размахивая
странный: странным
сейчас: сейчас
принцип: принципе
догадываться: догадывался
трындить: трындят
абориген: аборигены
вкратце: Вкратце
представляться: представлялось
ты: ты
ввести: ввл
предъява: предъяву
кидать: кидает
отмазыватся: отмазыватся
сказать: сказал
то: то
почему: почему
тогда: тогда
этот: этот
упырь: упырь
тычок: тычок
палец: пальцем
ржать: ржт
дикобраз: дикобраз
почем: почм
мазаться: мажется
вправду: вправду
один: Одно
работать: работает
нормально: нормально
симптом: симптомы
волосатый: волосатой
роже: роже
прочесть: прочесть
откуда: откуда
вообще: вообще
тут: тут
взяться: взяться
взмах: Взмах
кудато: кудато
за: за
спина: спину
видимо: видимо
намекать: намекая
илюхин: Илюхин
куча: кучу
камень: камней
дикий: дикого
похожий: похожие
экипировать: экипирован
слишком: слишком
хорошо: хорошо
настаивать: настаивать
посмотреть: посмотри
доставать: достат
из: из
стол: стола
абакан: Абакан
тыкать: тыкает
техногенный: техногенная
цацка: цацка
повезти: Повезло
слабоватый: слабовата
бронь: брони
ранить: ранен
больной: больное
воевать: воевал
грамотно: грамотно
ясный: Ясно
ведь: ведь
солдат: солдат
слушать: Слушай
хотеть: хотят
заводиться: заводиться
сделать: сделал
помочь: поможешь
вздыхать: Вздыхает
хоть: хоть
кусок: куски
резать: режь
толк: толку
вот: вот
только: только
делать: делать
приказать: прикажешь
ехидный: Ехидно
ухмыляться: ухмыляется
начальник: начальник
грудь: грудь
решать: решай
развернуться: развернувшись
отбыть: отбыл
забыть: забыв
прихватить: прихватить
задумчивый: задумчиво
разглядывать: разглядывал
глупо: глупо
улыбаться: улыбаться
потом: потом
решить: решив
ткнуть: ткнул
дно: Дно
ген: Ген
затем: Затем
изобразить: изобразив
вопросительный: вопросительную
мина: мину
ну: Ну
когда: когда
большой: больше
конструктивный: конструктивный
диалог: диалог
леонов: Леонов
сергеевич: Сергеевич
лео: Лео
повторить: повторил
пробовать: пробуя
слово: слово
вкус: вкус
обратить: обратив
никакой: никакого
внимание: вниманию
имя: имя
отчество: отчество
принимать: принимая
окончательный: окончательное
решение: решение
одновременно: одновременно
опять: опять
закатывать: закатывая
появиться: появились
два: два
здоровенный: здоровенных
молодец: молодца
поход: походу
караулить: караулили
знакомый: знакомых
бронировать: бронированных
скафандр: скафандрах
гермошлем: гермошлемов
быстренько: Быстренько
отстегнуть: отстегнули
стул: стула
подхватить: подхватив
воздвигнуть: воздвигли
вертикальный: вертикальное
положение: положение
несмотря: Несмотря
обезболивать: обезболивающие
свойство: свойства
вылечиться: вылечилось
естественный: естественным
образ: образом
напомнить: напомнив
охнуть: охнул
вырубился: вырубился
представлять: Представляем
отобрать: отобрали
схожий: схожую
название: названию
смысл: смысле
литература: литературу
надежда: надежде
предоставить: предоставить
читатель: читателей
больше: больше
вариант: вариантов
интересный: интересные
обсуждение: Обсуждение
мнение: мнения
оставить: Оставьте
думать: думаете
главный: главных
указать: Укажите
конкретно: конкретно
понравиться: понравилось
считать: считаете
