заголовок: Заголовок
олег: Олег
данильченко: Данильченко
имперский: Имперский
вояж: вояж
читать: читать
онлайн: онлайн
бесплатно: бесплатно
адрес: Адрес
здесь: здесь
быть: будет
возможность: Возможность
весь: Всем
текст: текст
электронный: электронной
книга: книге
совершенно: совершенно
целиком: целиком
полный: полную
версия: версию
в: в
некоторый: некоторых
случай: случаях
присутствовать: присутствует
краткий: краткое
содержание: содержание
город: Город
м: М
спб: СПб
год: лет
выпуск: выпуска
издательство: издательство
аста: АСТ
издательский: Издательский
дом: дом
ленинград: Ленинград
категория: категорию
боевой: Боевая
фантастика: фантастика
космический: Космическая
на: на
русский: русском
язык: языке
описание: описание
произведение: произведении
предисловие: предисловие
а: а
так: так
же: же
отзыв: отзывы
посетитель: посетителей
доступный: доступны
портал: портале
библиотека: Библиотека
либ: Либ
кат: Кат
создать: создана
для: для
любитель: любителей
полистать: полистать
хороший: хорошую
книжка: книжку
и: и
предлагать: Предлагаем
широкий: широкий
выбор: выбора
жанр: жанров
любовный: любовные
роман: романы
фэнтези: фэнтези
приключение: приключения
детектив: детективы
триллер: триллеры
эротика: эротика
документальный: документальные
научный: научные
юмористический: юмористические
анекдот: анекдоты
о: о
бизнес: бизнесе
проза: проза
детский: детские
сказка: сказки
религиия: религиии
новинка: новинки
православный: православные
старинный: старинные
про: про
компьютер: компьютеры
программирование: программирование
английский: английском
домоводство: домоводство
поэзия: поэзия
выбрав: Выбрав
по: по
душа: душе
вы: Вы
смочь: сможете
найти: нашли
действительно: действительно
стоить: стоящие
насладиться: насладиться
погружение: погружением
мир: мир
воображение: воображения
прочувствовать: прочувствовать
переживание: переживания
герой: героях
или: или
узнать: Узнайте
себя: себе
чтото: чтото
новый: новые
совершить: совершить
внутренний: внутреннее
открытие: открытие
подробный: Подробная
информация: информацию
ознакомление: ознакомления
текущий: текущему
запрос: запросу
представить: представлен
низкий: Ниже
к: к
чтение: чтение
аннотация: аннотацию
зависеть: зависит
от: от
тот: то
что: что
написать: напишите
сам: сама
автор: автора
если: Если
не: не
необходимый: необходимую
комментарий: комментарии
мы: Мы
постараться: постараемся
отыскать: отыскать
она: она
кто: Кто
фамилия: фамилию
как: как
звать: зовут
список: списком
его: его
серия: сериям
уважаемые: Уважаемые
правообладатель: правообладатели
размещать: размещать
наш: наши
сайт: сайте
у: у
любой: любой
зарегистрировать: зарегистрированного
пользователь: пользователя
ваш: ваши
опубликовать: опубликована
без: без
согласие: согласия
пожалуйста: пожалуйста
направить: направьте
жалоба: жалобу
заполните: заполните
форма: форму
обратный: обратной
связь: связи
течение: течение
час: часы
закрыть: закроем
доступ: доступ
нелегально: нелегально
разместить: размещенному
контент: контенту
разбить: разбитый
страница: страницу
система: Система
сохранение: сохранения
место: место
последний: последний
прочитать: прочитанные
позволять: позволяет
с: с
удобство: удобством
необходимость: необходимости
каждый: каждый
раз: раз
заново: заново
искать: искать
остановиться: остановился
поставить: поставим
закладка: Закладка
момент: момент
перейти: перейти
который: который
закончить: закончили
шрифт: Шрифт
интервал: Интервал
красный: Красный
четыре: четыре
приготовиться: Приготовься
жать: жать
кнопка: кнопку
готовый: готов
илья: Илья
выскочить: выскочил
гребень: гребень
холм: холма
бам: Бам
застучать: Застучало
броня: броне
раскрашивая: Раскрашивая
под: под
хохлом: хохлому
теперь: теперь
уже: уже
землянина: землянина
скафандр: скафандр
деактивировать: деактивирован
доложить: доложила
ди: Ди
я: я
знать: знаю
убить: Убили
над: Над
полигон: полигон
разнестись: разнесся
вой: вой
сирена: сирены
бой: боя
завершить: завершен
захват: захватом
база: базы
послышаться: послышался
бесстрастный: бесстрастный
голос: голос
искин: ИскИна
потерять: Потеряв
один: одного
человек: человека
победа: победу
одержать: одержала
команда: команде
господин: господина
бал: Балах
присуждаться: присуждается
первый: Первое
второй: Второе
занимать: занимает
госпожа: госпожи
маета: Маета
ре: Ре
орь: Ори
пенферро: Пенферро
соревнование: Соревнования
окончить: окончены
босс: Босс
мочь: могли
вставать: вставать
снова: Снова
активный: активен
кряхтя: кряхтя
подняться: поднялся
плохо: плохо
видно: видно
оптика: Оптику
заляпать: заляпало
краска: краской
изрядно: изрядно
но: но
коекак: коекак
можно: можно
разглядеть: разглядеть
окружать: окружающее
порадовать: порадовали
толпа: толпа
балбесов: балбесов
растерянно: растерянно
стоять: стоявшая
там: там
где: где
их: их
видеть: вижу
землянин: землянин
похоже: Похоже
они: они
шок: шоке
никак: никак
поверить: поверить
случиться: случилось
весело: весело
помахать: помахал
он: него
ручка: ручкой
направляться: направляясь
свой: своего
прилететь: Прилетело
сзади: сзади
учебный: учебной
граната: гранатой
бросить: бросило
вперед: вперед
внимание: вниманию
вновь: вновь
раздаться: раздался
получать: получает
штрафной: штрафное
очко: очко
после: После
завершение: завершения
стрельба: стрельба
строго: строго
запретить: запрещена
стрелять: стрелял
понять: понять
невозможный: невозможно
одинаково: одинаково
одеть: одеты
рука: руках
оружие: оружие
уверенный: уверен
отличиться: отличился
обычно: обычно
пил: Пиле
ну: Ну
подумать: подумал
галочка: галочку
прийтись: придтся
ответить: ответил
еще: ещ
за: за
это: это
лис: Лис
ты: тебя
подскочить: подскочили
ребята: Ребята
когда: когда
добраться: добрался
до: до
открыть: открыта
дверь: дверь
да: Да
нормально: нормально
сделаться: сделается
умереть: Умер
воскреснуть: воскрес
привычно: Привычно
главный: главных
победить: победили
синяк: синяки
пройти: пройдут
точно: точно
отмажуться: отмажешься
рассказ: рассказа
похождение: похождениях
все: Вс
рассказать: рассказать
обещать: Обещал
заявить: заявила
беррана: Беррана
снимать: снимайте
шлем: шлем
оказаться: оказался
комната: комнату
ожидание: ожидания
вести: ведущая
закрыться: закрылась
пожать: пожал
плечо: плечами
откуда: откуда
почему: почему
устроить: Устроим
вечер: вечер
знакомство: знакомства
сказать: сказали
то: то
толком: толком
познакомиться: познакомились
открыться: открылась
ворваться: ворвался
словно: словно
помолодеть: помолодел
скинуть: скинув
пара: пару
десяток: десятков
глаз: Глаза
гореть: горят
улыбка: улыбок
ухо: уха
возбудить: Возбужден
аж: аж
подпрыгивать: подпрыгивал
молодец: молодец
старик: старика
давно: Давно
смеяться: смеялся
ткнуть: ткнул
палец: пальцем
вверх: вверх
капитан: Капитан
злой: злой
орет: орт
леди: Леди
ри: Ри
шипеть: шипит
тоже: тоже
метать: мечет
молния: молнии
выстрелить: выстрелил
спина: спину
лео: Лео
задушить: задушит
этот: эти
тупой: тупого
недоносок: недоноска
короче: Короче
наделать: наделали
шорох: шороху
лицо: лицам
рад: рады
ли: ли
наставник: Наставник
обвести: обвел
удивленный: удивленным
взгляд: взглядом
рада: Рады
только: только
усталь: устали
маленько: маленько
тогда: Тогда
пойти: Пошли
разоблачаться: разоблачаться
потом: Потом
обед: обед
два: два
отдых: отдыха
затем: затем
рукопашка: рукопашка
сложность: сложностей
возникнуть: возникнет
формальный: формально
арсенал: арсенале
возбуждение: возбуждении
зевран: Зевран
сиять: сияя
начистить: начищенный
медный: медный
чайник: чайник
встретить: встретил
практически: практически
точный: точной
копия: копией
речь: речи
произнести: произнесенной
ровно: ровно
пять: пять
минута: минут
назад: назад
засмеяться: засмеялись
дед: дед
непонимающий: непонимающе
уставиться: уставился
немного: немного
обидеть: обиженным
выражение: выражением
обижаться: обижайся
старый: старый
просто: просто
слово: слов
повторить: повторить
мой: мо
аааа: Аааа
засиять: засиял
старец: старец
ничто: ничего
страшный: страшного
ребятки: ребятки
нет: нет
берран: Беррана
каков: какова
попадание: попадание
мишень: мишень
невероятный: невероятное
полтора: полтора
квадратный: квадратных
сантиметр: сантиметра
мелькнуть: мелькнуло
мгновение: мгновение
ж: ж
рассчитать: рассчитать
надо: надо
талант: талант
дочка: дочка
время: время
командир: командира
подразделение: подразделений
передраться: передрались
бы: бы
покраснеть: покраснела
удовольствие: удовольствия
небольшой: небольшого
чувство: чувство
неловкость: неловкости
хвалить: хвалят
всегда: всегда
приятный: приятно
заслуженно: заслуженно
вдвойне: вдвойне
риго: Риго
опыт: Опыта
хватать: хватает
работать: работать
хорошо: хорошо
кроха: крохи
действовать: действовали
давать: давайте
железо: железо
близкий: ближайшее
жестянка: жестянки
большой: больше
понадобиться: понадобятся
надеяться: Надеюсь
никогда: никогда
подождать: Подождите
бер: Бер
репертуар: репертуаре
действие: действия
вряд: Вряд
справиться: справились
руководство: руководства
продумать: продумал
заранее: заранее
вооружение: вооружение
командовать: Командовал
делать: делать
честно: честно
вообще: вообще
растеряться: растерялась
вначале: вначале
полностью: полностью
поддерживать: поддерживают
обидный: обидно
мгновенно: Мгновенно
забыть: забыты
недавний: недавние
недоразумение: недоразумения
тяжелый: тяжлый
разговор: разговор
сработать: Сработало
локоть: локтя
появляться: появляется
сплоченный: сплоченной
вот: Вот
илюха: Илюха
подвести: подведут
получиться: получилось
пусть: Пусть
коряво: коряво
некрасивый: некрасиво
сплотиться: сплотились
единый: единый
организм: организм
отныне: отныне
представлять: Представляем
похожий: похожие
отобрать: отобрали
схожий: схожую
название: названию
смысл: смысле
литература: литературу
надежда: надежде
предоставить: предоставить
читатель: читателей
больше: больше
вариант: вариантов
интересный: интересные
обсуждение: Обсуждение
собственный: собственные
мнение: мнения
оставить: Оставьте
думать: думаете
указать: Укажите
конкретно: конкретно
понравиться: понравилось
считать: считаете
