заголовок: Заголовок
олег: Олег
данильченко: Данильченко
имперский: Имперский
вояж: вояж
читать: читать
онлайн: онлайн
бесплатно: бесплатно
адрес: Адрес
здесь: Здесь
быть: есть
возможность: Возможность
весь: всех
текст: текст
электронный: электронной
книга: книге
совершенно: совершенно
целиком: целиком
полный: полную
версия: версию
в: в
некоторый: некоторые
случай: случае
присутствовать: присутствует
краткий: краткое
содержание: содержание
город: Город
м: М
спб: СПб
год: год
выпуск: выпуска
издательство: издательство
аста: АСТ
издательский: Издательский
дом: дом
ленинград: Ленинград
категория: категорию
боевой: Боевая
фантастика: фантастика
космический: Космическая
на: на
русский: русском
язык: языке
описание: описание
произведение: произведении
предисловие: предисловие
а: а
так: так
же: же
отзыв: отзывы
посетитель: посетителей
доступный: доступны
портал: портале
библиотека: Библиотека
либ: Либ
кат: Кат
создать: создали
для: для
любитель: любителей
полистать: полистать
хороший: лучшего
книжка: книжку
и: и
предлагать: Предлагаем
широкий: широкий
выбор: выбора
жанр: жанров
любовный: любовные
роман: романы
фэнтези: фэнтези
приключение: приключения
детектив: детективы
триллер: триллеры
эротика: эротика
документальный: документальные
научный: научные
юмористический: юмористические
анекдот: анекдоты
о: о
бизнес: бизнесе
проза: проза
детский: детские
сказка: сказки
религиия: религиии
новинка: новинки
православный: православные
старинный: старинные
про: про
компьютер: компьютеры
программирование: программирование
английский: английском
домоводство: домоводство
поэзия: поэзия
выбрав: Выбрав
по: по
душа: душе
вы: Вы
смочь: смогли
найти: нашли
действительно: действительно
стоить: стоящие
насладиться: насладиться
погружение: погружением
мир: мир
воображение: воображения
прочувствовать: прочувствовать
переживание: переживания
герой: героях
или: или
узнать: Узнайте
себя: себя
чтото: чтото
новый: новые
совершить: совершить
внутренний: внутреннее
открытие: открытие
подробный: Подробная
информация: информацию
ознакомление: ознакомления
текущий: текущему
запрос: запросу
представить: представлен
низкий: Ниже
к: к
чтение: чтение
аннотация: аннотацию
зависеть: зависит
от: от
тот: тех
что: что
написать: напишите
сам: сам
автор: автора
если: Если
не: не
необходимый: необходимую
комментарий: комментарии
мы: Мы
постараться: постараемся
отыскать: отыскать
она: ней
кто: Кто
фамилия: фамилию
как: как
звать: зовут
список: списком
его: его
серия: сериям
уважаемые: Уважаемые
правообладатель: правообладатели
размещать: размещать
наш: нашего
сайт: сайте
у: у
любой: любой
зарегистрировать: зарегистрированного
пользователь: пользователя
ваш: ваши
опубликовать: опубликована
без: без
согласие: согласия
пожалуйста: пожалуйста
направить: направленных
жалоба: жалобу
заполните: заполните
форма: форму
обратный: обратной
связь: связи
течение: течение
час: часов
закрыть: закроем
доступ: доступ
нелегально: нелегально
разместить: размещенному
контент: контенту
разбить: разбитый
страница: страницу
система: Система
сохранение: сохранения
место: места
последний: последние
прочитать: прочитанные
позволять: позволяет
с: с
удобство: удобством
необходимость: необходимости
каждый: каждой
раз: Раз
заново: заново
искать: искать
остановиться: остановились
поставить: Поставьте
закладка: Закладка
момент: момент
перейти: перейти
который: котором
закончить: закончили
шрифт: Шрифт
интервал: Интервал
честно: Честно
говорить: говорил
я: я
толком: толком
даже: даже
представлять: Представляем
ночь: ночь
думать: думаете
но: но
определиться: определился
ладно: Ладно
встрять: встрял
зевран: Зевран
действовать: действовать
идеал: идеале
рассчитывать: рассчитываю
вообще: вообще
стрелять: стрелять
нужный: нужный
заманить: заманить
противник: противника
узкость: узкость
конечно: конечно
такой: такое
полигон: полигоне
пара: пару
взрыв: взрывов
положить: положить
оптом: оптом
желательно: Желательно
чтобы: чтобы
это: этого
случиться: случилось
близкий: ближе
база: базе
этот: этом
продолжать: продолжал
рассуждать: рассуждать
илья: Илья
выжить: выжившие
ряд: рядах
ввязываться: ввязываясь
бой: бой
быстрый: быстрый
марш: маршем
выдвигаемся: выдвигаемся
вражеский: вражеской
заканчивать: заканчиваем
захват: захватом
пока: Пока
землянин: землянин
вещать: вещал
старик: Старик
удовлетворенно: удовлетворенно
кивать: кивал
бал: Балах
довольно: довольно
улыбаться: улыбался
узкостеть: узкостей
один: одного
илюха: Илюха
задуматься: задумался
секунда: секунд
вряд: Вряд
ли: ли
искин: ИскИн
предоставить: предоставить
ровный: ровным
стол: стола
поверхность: поверхность
ладонь: ладони
ничто: ничего
помочь: поможет
одеться: оденемся
самый: самые
тяжелый: тяжлое
броня: броню
забывать: забывайте
меньше: меньше
близняшка: близняшек
взгляд: взгляд
сторона: сторону
энци: Энци
богатый: богатым
опыт: опытом
маловероятный: маловероятно
бы: бы
подобрать: подобрать
защита: защиту
нее: не
вооружение: вооружению
взять: взять
вот: вот
получаться: получается
плотность: плотности
мощность: мощности
огонь: огня
проигрывать: проигрываем
изначально: изначально
нет: нет
мотнуть: мотнул
голова: головой
он: него
скорый: Скорее
значить: значит
проход: проходов
между: между
складка: складками
местность: местности
большой: большой
доля: долей
вероятность: вероятности
воспользоваться: воспользуемся
несколько: несколько
никто: никто
мешать: мешает
заминировать: заминировать
да: да
скорость: скорость
скрытность: скрытность
более: Более
мочь: может
противопоставить: противопоставить
исходить: исходя
из: из
иметь: имеем
насчет: насчт
стрелковый: стрелкового
хотеть: хотел
спросить: спросил
совет: совета
уважаемый: уважаемый
главный: главных
оружейник: оружейников
ну: Ну
ухмыльнуться: ухмыльнулся
дед: дед
целое: целом
подходящий: подходяще
ты: Ты
черим: Черим
годиться: Годится
согласиться: согласился
старый: Старый
вояка: вояка
вновь: вновь
еще: ещ
согласный: согласны
ведь: Ведь
мальчишка: мальчишка
почти: почти
слово: слово
повторить: повторил
вчера: вчера
подумать: подумал
вслух: вслух
произнести: произнес
тогда: тогда
посоветовать: посоветовал
два: двух
снайперский: снайперских
ружье: ружья
рс: РС
б: Б
тут: тут
восхищенно: восхищенно
воскликнуть: воскликнул
ж: ж
вроде: вроде
облазить: облазил
однако: однако
видеть: видел
ни: ни
плохо: Плохо
лазить: лазил
улыбнуться: улыбнулся
тридцать: тридцать
зуб: зуба
воздеть: воздел
указательный: указательный
палец: палец
вверх: вверх
твой: твоей
команда: командам
парочка: парочка
найтись: найдется
важно: важно
удалиться: удалился
минута: минуту
склад: склада
вернуться: вернулся
нести: неся
рука: руках
блестящий: блестящему
кофр: кофры
сказать: скажу
открывать: открывая
они: Они
буквально: Буквально
месяц: месяц
назад: назад
заказать: заказал
знать: знал
понадобиться: понадобятся
образец: образцы
зато: зато
изношенный: изношенные
уже: уже
готовый: готовый
эксплуатация: эксплуатации
подготовить: подготовил
пристрелять: пристрелял
разработка: разработки
секрет: секрету
уважать: уважающий
снайпер: снайпер
выбрать: выберет
именно: именно
оружие: оружие
спецподразделение: спецподразделениях
использовать: использовали
только: Только
много: много
наделать: наделали
успеть: успел
договорить: договорить
беррана: Беррана
лежать: лежали
открытый: открытые
легко: легко
держать: держала
довольнотаки: довольнотаки
массивный: массивное
ласково: ласково
поглаживая: поглаживая
знакомый: знакома
удивить: удивленный
поведение: поведением
девушка: девушки
кивнуть: кивнула
дома: дома
отец: Отец
часто: часто
брать: брал
охота: охоту
горный: Горные
сибер: сиберы
очень: очень
осторожный: осторожные
животное: животные
за: за
подпустить: подпустят
охотник: охотник
расстояние: расстоянии
выстрел: выстрела
обычный: обычного
охотничий: охотничьего
можно: можно
достать: достать
тысяча: тысяч
метр: метров
падение: падения
подойти: подойти
максимум: максимум
полтора: полтора
километр: километра
иногда: иногда
чуть: чуть
сибера: сибера
молодой: молодая
выходить: выходит
лучше: лучше
правда: Правда
прицел: прицел
попроще: попроще
илио: Илио
другой: другим
повезти: повезло
обрадоваться: обрадовался
уж: уж
дело: дело
пользоваться: пользоваться
дочка: дочка
второй: второй
экземпляр: экземпляр
отдать: отдал
риго: Риго
парень: парень
совладать: совладаешь
великий: великий
ответить: ответил
норк: Норк
уважительно: уважительно
покоситься: покосившись
бер: Бер
дистанция: дистанциях
справиться: справлюсь
подстраховать: подстрахую
добавить: добавила
внимание: вниманию
похожий: похожие
отобрать: отобрали
схожий: схожую
название: названию
смысл: смысле
литература: литературу
надежда: надежде
читатель: читателей
больше: больше
вариант: вариантов
интересный: интересные
обсуждение: Обсуждение
просто: просто
собственный: собственные
мнение: мнения
оставить: Оставьте
указать: Укажите
конкретно: конкретно
понравиться: понравилось
почему: почему
считать: считаете
