заголовок: Заголовок
олег: Олег
данильченко: Данильченко
имперский: Имперский
вояж: вояж
читать: читать
онлайн: онлайн
бесплатно: бесплатно
адрес: Адрес
здесь: здесь
быть: был
возможность: Возможность
весь: все
текст: текст
электронный: электронной
книга: книге
совершенно: совершенно
целиком: целиком
полный: полную
версия: версию
в: в
некоторый: некоторых
случай: случае
присутствовать: присутствует
краткий: краткое
содержание: содержание
город: Город
м: М
спб: СПб
год: год
выпуск: выпуска
издательство: издательство
аста: АСТ
издательский: Издательский
дом: дом
ленинград: Ленинград
категория: категорию
боевой: Боевая
фантастика: фантастика
космический: Космическая
на: на
русский: русском
язык: языке
описание: описание
произведение: произведении
предисловие: предисловие
а: а
так: так
же: же
отзыв: отзывы
посетитель: посетителей
доступный: доступны
портал: портале
библиотека: Библиотека
либ: Либ
кат: Кат
создать: создана
для: для
любитель: любителей
полистать: полистать
хороший: Хорошо
книжка: книжку
и: и
предлагать: Предлагаем
широкий: широкий
выбор: выбора
жанр: жанров
любовный: любовные
роман: романы
фэнтези: фэнтези
приключение: приключения
детектив: детективы
триллер: триллеры
эротика: эротика
документальный: документальные
научный: научные
юмористический: юмористические
анекдот: анекдоты
о: о
бизнес: бизнесе
проза: проза
детский: детские
сказка: сказки
религиия: религиии
новинка: новинки
православный: православные
старинный: старинные
про: про
компьютер: компьютеры
программирование: программирование
английский: английском
домоводство: домоводство
поэзия: поэзия
выбрав: Выбрав
по: по
душа: душе
вы: Вы
смочь: смогли
найти: нашли
действительно: действительно
стоить: стоило
насладиться: насладиться
погружение: погружением
мир: мир
воображение: воображения
прочувствовать: прочувствовать
переживание: переживания
герой: героях
или: или
узнать: Узнайте
себя: себе
чтото: чтото
новый: новые
совершить: совершить
внутренний: внутреннее
открытие: открытие
подробный: Подробная
информация: информацию
ознакомление: ознакомления
текущий: текущему
запрос: запросу
представить: представлен
низкий: Ниже
к: К
чтение: чтение
аннотация: аннотацию
зависеть: зависит
от: от
тот: тем
что: что
написать: напишите
сам: самому
автор: автора
если: если
не: не
необходимый: необходимую
комментарий: комментарии
мы: Мы
постараться: постараемся
отыскать: отыскать
она: ней
кто: Кто
фамилия: фамилию
как: Как
звать: зовут
список: списком
его: его
серия: сериям
уважаемые: Уважаемые
правообладатель: правообладатели
размещать: размещать
наш: нашем
сайт: сайте
у: у
любой: любые
зарегистрировать: зарегистрированного
пользователь: пользователя
ваш: ваши
опубликовать: опубликована
без: без
согласие: согласия
пожалуйста: пожалуйста
направить: направьте
жалоба: жалобу
заполните: заполните
форма: форму
обратный: обратной
связь: связи
течение: течение
час: часов
закрыть: закроем
доступ: доступ
нелегально: нелегально
разместить: размещенному
контент: контенту
разбить: разбитый
страница: страницу
система: системы
сохранение: сохранения
место: месте
последний: последней
прочитать: прочитанные
позволять: позволяет
с: со
удобство: удобством
необходимость: необходимости
каждый: каждый
раз: раз
заново: заново
искать: искать
остановиться: остановились
поставить: Поставьте
закладка: Закладка
момент: момент
перейти: перейти
который: которого
закончить: закончили
шрифт: Шрифт
интервал: Интервал
хорошо: хорошо
я: мной
согласный: согласен
бездна: бездна
побрать: побери
готовый: готов
заключить: заключить
договор: договор
под: под
протокол: протокол
подождать: подождать
уважаемый: уважаемый
ну: Ну
еще: ещ
буквально: буквально
зарычать: зарычал
взбесить: взбешенный
ученый: ученых
это: этого
надо: надо
делать: делать
сразу: сразу
ехидно: ехидно
заявить: заявил
илья: Илья
после: после
тут: Тут
наговорить: наговорили
требовать: требую
база: базы
знание: знаний
советовать: советую
соглашаться: соглашаться
потому: потому
противный: противном
цена: ценой
только: только
возрастать: возрастать
время: время
нет: нет
аааааааааа: Аааааааааа
проклятый: прокляты
заорать: заорал
бешенство: бешенстве
няга: Нягу
куда: Куда
деться: делись
манера: манеры
заявлять: Заявляю
пойти: Пойдемте
сейчас: сейчас
спешить: спешил
яйцеголовый: яйцеголовый
эскулап: эскулап
но: но
обращать: обращая
он: он
внимание: вниманию
спуститься: спустился
холл: холл
где: где
выслушать: выслушал
куча: кучу
упрек: упреков
энди: Энди
за: за
долго: долго
задержаться: задержится
затем: затем
больше: больше
когда: когда
сказать: скажешь
день: дня
три: три
вменить: вменили
подозрение: подозрения
измена: измене
хотеть: хотел
отвертеться: отвертеться
женитьба: женитьбы
вообще: вообще
изменить: изменил
империя: Империи
огромный: Огромных
труд: трудов
уговорить: уговорить
понимать: понимал
ведь: ведь
всего: всего
шесть: шесть
отпуск: отпуска
они: их
оставаться: оставалось
до: до
прийтись: придтся
отправиться: отправиться
очередной: очередной
двухмесячный: двухмесячный
поход: поход
обещание: обещание
остаться: оставшихся
устроить: устроит
такой: такой
отдых: отдых
помнить: Помнил
жизнь: жизнь
успокоить: успокоить
примирить: примирить
неизбежный: неизбежным
расстаться: Расставшись
будущий: будущей
жена: женой
родственник: родственником
лицо: лица
брат: брата
утащить: утащить
лаборатория: лаборатории
перед: перед
джойло: Джойл
объяснять: объяснял
минута: минут
пять: пять
при: при
здоровенный: здоровенный
кулак: кулак
мелькать: мелькал
опасный: опасной
близость: близости
несчастный: несчастного
похоже: Похоже
договориться: договорились
напоследок: напоследок
получить: Получив
хлопок: хлопок
спина: спине
еле: еле
удержаться: удержался
нога: ногах
уже: уже
ничто: ничего
мешать: мешало
вцепиться: вцепиться
мертвый: мртвой
хватка: хваткой
рукав: рукав
комбинезон: комбинезонах
святой: святых
остервенение: остервенением
накинуться: накинулись
человек: люди
белый: белых
маска: масках
полностью: полностью
скрывать: скрывающих
понятно: понятно
вакуумный: вакуумная
гигиена: гигиена
мать: мать
мигом: мигом
раздеть: раздели
донага: донага
вымыть: вымыли
самый: самым
бесцеремонный: бесцеремонным
образ: образом
удалить: удалили
зачемто: зачемто
волос: волосы
тело: тело
успеть: успел
героический: героических
усилие: усилий
угроза: угрозой
отказ: отказа
эксперимент: эксперимента
отстоять: отстоять
ресница: ресницы
бровь: брови
уж: Уж
очень: очень
хотеться: хотелось
похожий: похожие
пиратский: пиратского
коротышка: коротышку
задавать: задавать
дурацкий: дурацкие
вопрос: вопросы
чужой: чужом
этот: этого
удаться: удалось
череп: черепе
обработать: обработали
испугаться: испугался
вырасти: вырастут
ли: ли
снова: снова
ответ: ответ
да: да
мол: мол
немного: немного
успокоиться: успокоились
начаться: начались
анализ: анализы
какой: какие
дырка: дырки
простить: прости
господь: господи
блаженная: блаженные
сунуть: сунули
свой: свой
нос: нос
продолжаться: продолжалось
глубокий: глубокой
ночь: ночи
илюха: Илюха
набить: набить
ктонибудь: комунибудь
рожа: рожу
хоть: хоть
бы: бы
вон: вон
здоровый: здоровому
лаборант: лаборанту
прекратиться: прекратилось
отвести: отвели
палата: палату
накормить: накормили
пузо: пуза
уложить: уложили
спать: спать
мочь: могли
вколоть: вкололи
успокаивать: успокаивающее
поди: поди
уследить: уследи
толпа: толпа
всякий: всякими
непонятный: непонятными
штука: штуками
рука: руках
там: там
ни: ни
вырубиться: вырубился
полпути: полпути
подушка: подушке
разбудить: Разбудили
рано: рано
одеть: одели
какойто: какойто
подобие: подобие
накидка: накидки
видимо: Видимо
чтобы: чтобы
сверкать: сверкал
мудь: мудями
голый: голыми
ягодица: ягодицами
смущая: смущая
целомудренный: целомудренные
взор: взоры
местный: местных
женский: женского
персонал: персонала
отвлекать: отвлекая
важный: важной
работа: работы
догадка: Догадка
скорый: скорее
верный: верна
довести: довели
ктото: ктото
незаметный: незаметный
ловко: ловко
сдернуть: сдрнул
лоскут: лоскут
затолкать: затолкали
больший: большую
медкапсула: медкапсулу
короче: короче
большой: больше
сниться: снились
кошмар: кошмары
опять: опять
война: войне
стрелять: стрелял
чеченский: чеченских
боевик: боевиков
плен: плену
ползти: полз
мокрый: мокрому
снег: снегу
волочить: волоча
чувствовать: чувствующих
холод: холода
руках: руках
раненый: раненого
демьяненко: Демьяненко
потом: потом
очнуться: очнулся
голов: Голова
болеть: болели
ломить: ломило
даже: даже
кость: кости
боль: Боль
конечно: конечно
терпимый: терпимая
подумать: подумал
проехать: проехал
асфальтоукладчик: асфальтоукладчик
то: то
самочувствие: самочувствии
нарисоваться: нарисовался
начать: начал
разный: разные
вяло: вяло
отвечать: отвечал
хреновый: хреново
постоянно: постоянно
тошнить: тошнило
извинить: извините
горшок: горшок
называться: называется
палец: пальцем
затыкать: затыкай
выдержать: выдержал
из: изо
сила: сил
метнулся: метнулся
кабанчик: кабанчиком
поиск: поисках
унитаз: унитаза
думать: думаете
путь: пути
через: через
максимум: максимум
десять: десять
секунда: секунд
обнаружить: обнаружит
оный: оный
наделать: наделает
первый: первую
подходящий: подходящую
емкость: мкость
пусть: пусть
храниться: хранятся
многомиллионный: многомиллионные
стоимость: стоимости
нейросеть: нейросети
говорить: говорят
народ: народе
насратить: насрать
роза: розами
засыпать: засыпать
счастие: счастью
обитатель: обитателей
искомый: искомый
найтись: нашелся
вовремя: вовремя
обойтись: обойтись
просто: просто
ровный: ровной
поверхность: поверхностью
пол: пола
забег: забега
испуганный: испуганными
крик: криками
нестись: неслась
экспериментатор: экспериментаторы
решить: решили
пытаться: пытается
скоропостижный: скоропостижно
скрыться: скрыться
неизвестный: неизвестном
направление: направлении
вместе: вместе
их: их
результат: результаты
услышать: услышали
изза: изза
стеклянный: стеклянной
перегородка: перегородки
санузел: санузла
характерный: характерные
звук: звуки
спокойный: спокоен
прохватить: прохватил
дрище: дрищ
многолетний: многолетних
изыскание: изысканий
кануть: кануть
недра: недра
фановый: фановой
филиал: филиала
корпорация: корпорации
нейротех: Нейротех
безвозвратный: безвозвратно
представлять: Представляем
отобрать: отобрали
схожий: схожую
название: названию
смысл: смысле
литература: литературу
надежда: надежде
предоставить: предоставить
читатель: читателей
вариант: вариантов
интересный: интересные
обсуждение: Обсуждение
собственный: собственные
мнение: мнения
оставить: Оставьте
главный: главных
указать: Укажите
конкретно: конкретно
понравиться: понравилось
почему: почему
считать: считаете
