заголовок: Заголовок
олег: Олег
данильченко: Данильченко
имперский: Имперский
вояж: вояж
читать: читать
онлайн: онлайн
бесплатно: бесплатно
адрес: адрес
здесь: здесь
быть: было
возможность: Возможность
весь: всем
текст: текст
электронный: электронной
книга: книге
совершенно: совершенно
целиком: целиком
полный: полную
версия: версию
в: в
некоторый: некоторых
случай: случаях
присутствовать: присутствует
краткий: краткое
содержание: содержание
город: Город
м: М
спб: СПб
год: год
выпуск: выпуска
издательство: издательство
аста: АСТ
издательский: Издательский
дом: дома
ленинград: Ленинград
категория: категорию
боевой: Боевая
фантастика: фантастика
космический: Космическая
на: на
русский: русском
язык: языке
описание: описание
произведение: произведении
предисловие: предисловие
а: а
так: так
же: же
отзыв: отзывы
посетитель: посетителей
доступный: доступны
портал: портале
библиотека: Библиотека
либ: Либ
кат: Кат
создать: создана
для: для
любитель: любителей
полистать: полистать
хороший: лучшее
книжка: книжку
и: и
предлагать: Предлагаем
широкий: широкий
выбор: выбора
жанр: жанров
любовный: любовные
роман: романы
фэнтези: фэнтези
приключение: приключения
детектив: детективы
триллер: триллеры
эротика: эротика
документальный: документальные
научный: научные
юмористический: юмористические
анекдот: анекдоты
о: о
бизнес: бизнесе
проза: проза
детский: детские
сказка: сказки
религиия: религиии
новинка: новинки
православный: православные
старинный: старинные
про: про
компьютер: компьютеры
программирование: программирование
английский: английском
домоводство: домоводство
поэзия: поэзия
выбрав: Выбрав
по: по
душа: душе
вы: Вы
смочь: смогут
найти: нашли
действительно: действительно
стоить: стоит
насладиться: насладиться
погружение: погружением
мир: мир
воображение: воображения
прочувствовать: прочувствовать
переживание: переживания
герой: героях
или: или
узнать: Узнайте
себя: себе
чтото: чтото
новый: новые
совершить: совершить
внутренний: внутреннее
открытие: открытие
подробный: Подробная
информация: информацию
ознакомление: ознакомления
текущий: текущему
запрос: запросу
представить: представлен
низкий: Ниже
к: к
чтение: чтение
аннотация: аннотацию
зависеть: зависит
от: от
тот: тем
что: что
написать: напишите
сам: сами
автор: автора
если: если
не: не
необходимый: необходимую
комментарий: комментарии
мы: Мы
постараться: постараемся
отыскать: отыскать
она: ей
кто: кто
фамилия: фамилию
как: как
звать: зовут
список: списком
его: его
серия: сериям
уважаемые: Уважаемые
правообладатель: правообладатели
размещать: размещать
наш: нашем
сайт: сайте
у: у
любой: любой
зарегистрировать: зарегистрированного
пользователь: пользователя
ваш: ваши
опубликовать: опубликована
без: без
согласие: согласия
пожалуйста: пожалуйста
направить: направьте
жалоба: жалобу
заполните: заполните
форма: форме
обратный: обратной
связь: связи
течение: течение
час: часов
закрыть: закроем
доступ: доступ
нелегально: нелегально
разместить: размещенному
контент: контенту
разбить: разбитый
страница: страницу
система: Система
сохранение: сохранения
место: места
последний: последнюю
прочитать: прочитанные
позволять: позволяет
с: с
удобство: удобством
необходимость: необходимости
каждый: каждый
раз: Раз
заново: заново
искать: искать
остановиться: остановились
поставить: Поставьте
закладка: Закладка
момент: момент
перейти: перейти
который: который
закончить: закончить
шрифт: Шрифт
интервал: Интервал
этот: этим
два: Две
понятный: Понятно
сказать: сказано
удасться: удасться
то: то
близнец: близнецами
однозначно: однозначно
папа: Папа
они: их
композитор: композитор
чтобы: чтобы
сильно: сильно
известный: известный
но: но
узкий: узких
круг: кругах
богема: богемы
слово: словам
девчонка: девчонки
вполне: вполне
почитать: почитаем
мама: Мама
соответственно: соответственно
тоже: тоже
работник: работники
высокий: высокого
искусство: искусства
только: только
уже: уже
стезя: стезе
оральноакустический: оральноакустической
певица: певица
проще: проще
выясниться: Выяснилось
также: также
милла: Милла
рилла: Рилла
унаследовать: унаследовали
родитель: родители
самый: самыми
абсолютный: абсолютный
слух: слух
красивый: красивый
бархатный: бархатный
голос: голос
яркий: яркую
внешность: внешность
видно: видно
невооруженный: невооруженным
глаз: глазом
казаться: Казалось
бы: бы
иметь: имеют
шанс: шанс
влиться: влиться
гламурный: гламурную
толпа: толпу
ана: ан
нет: нет
счет: счт
девица: девицы
свой: своей
мнение: мнения
вернее: Вернее
правильнее: правильнее
оказаться: оказались
далеко: далеко
банально: Банально
развести: развели
слабо: слабо
произойти: произошло
это: этом
приблизительно: приблизительно
один: одной
из: из
благотворительный: благотворительных
тусовка: тусовок
устроить: устроенной
какойто: какойто
толстосум: толстосумом
честь: честь
доблестный: доблестных
естественно: естественно
непобедимый: непобедимой
армия: армии
император: императора
глубоко: глубоко
подшофе: подшофе
красотка: красотки
наглость: наглость
высказаться: высказаться
пренебрежительно: пренебрежительно
тип: Типа
вдруг: вдруг
такой: таким
почесть: почести
нигде: нигде
данный: данное
воевать: воюют
денежка: денежки
сосать: сосут
бюджет: бюджета
империя: Империи
очень: очень
некислый: некисло
бедный: бедные
налогоплательщик: налогоплательщики
энци: Энци
причислять: причисляли
любимый: любимые
надрываться: надрывается
отдавать: Отдавая
краюха: краюху
хлеб: хлеба
защитник: защитников
сползать: сползала
броня: броня
причина: причине
крайний: крайней
истощенность: истощнности
организм: организмов
ответ: ответ
заявление: заявления
заклятый: заклятые
подруга: подруги
оба: оба
поднять: подняли
смех: смех
мол: Мол
тут: тут
вообще: вообще
неудачница: неудачницы
кроме: кроме
драть: драть
глотка: глотки
сцена: сцене
большой: больше
ни: ни
годиться: годятся
папан: папан
маман: Маман
вовремя: вовремя
подсуетиться: подсуетятся
подача: подачу
стерпеть: стерпеть
невозможный: невозможно
дело: дело
кнопка: кнопки
заявить: заявили
всеуслышание: всеуслышание
еще: ещ
показать: показать
доказать: доказать
стоять: стоят
вот: вот
кааак: кааак
пойти: пойдут
да: да
кааак: кааак
стать: станут
пилот: пилота
тогда: тогда
обалдеть: обалдеете
под: под
приличный: приличным
воздействие: воздействием
алкоголь: алкоголя
коечего: коечего
менее: менее
услышать: услышано
многий: многими
потом: потом
начаться: начались
постоянный: постоянные
подначка: подначки
когда: когда
выскочка: выскочки
короткий: Короче
жизнь: жизнь
превратиться: превратилась
ад: ад
психануть: психанули
покидать: покидают
отчий: отчий
дабы: дабы
освоить: освоить
героический: героическую
профессия: профессию
смычком: смычком
делать: деланы
предок: предки
шок: шоке
лежать: лежала
кровать: кровати
картинно: картинно
заломить: заломив
отчаяние: отчаянии
рука: руки
даже: даже
ситуация: ситуации
актриса: актриса
изменить: изменила
имидж: имиджу
конечно: конечно
хлопотать: хлопотал
вокруг: вокруг
супруг: супруги
подносить: поднося
вода: воду
пилюлю: пилюлю
мигрень: мигрени
ну: ну
там: там
местный: местный
женщина: женщин
болеть: болит
понятно: Понятно
отказаться: отказались
проспонсировать: проспонсировать
мероприятие: мероприятие
девчуха: девчухи
робкий: робкого
десяток: десятка
собрать: Собрав
накопить: накопленные
средство: средства
сэкономить: сэкономили
школьный: школьных
завтрак: завтраках
карманный: карманных
деньга: денег
бедствовать: бедствуют
отправиться: отправились
филиал: филиал
корпорация: корпорации
нейротех: НЕЙРОТЕХ
впендюрить: впендюрили
нейросеть: нейросети
пилот: Пилот
му: МУ
остаться: оставшиеся
проплатить: проплатили
учебный: учебное
заведение: заведение
где: где
сейчас: сейчас
счастие: счастье
находиться: находиться
дунули: Дунули
сюда: сюда
заранее: заранее
справедливо: справедливо
полагать: полагая
безутешный: безутешные
кинуться: кинутся
погоня: погоню
правый: правы
неделя: недели
осаждать: осаждали
порог: пороги
школа: школе
пигалица: пигалицы
бояться: боялись
высунуть: высунуть
оттуда: оттуда
носик: носики
папик: Папик
попытаться: попытался
закатить: закатить
скандал: скандал
он: ему
цензурный: цензурной
хоть: хоть
несколько: несколько
грубовато: грубовато
объяснить: объяснили
желание: желание
гражданин: гражданина
закон: закон
нарушать: нарушать
преступный: преступно
однако: Однако
заверить: заверили
вряд: вряд
ли: ли
изнеженный: изнеженные
скорый: Скорее
сбегут: сбегут
появиться: появился
первый: первые
трудность: трудности
надо: Надо
подождать: подождать
немного: немного
чадо: чада
вернуться: Вернись
родственный: родственные
объятие: объятия
правда: Правда
потратить: потраченных
при: при
вернуть: вернуть
успокоить: Успокоенные
образ: образом
снять: сняли
осада: осаду
девушка: девушки
теперь: теперь
полноправный: полноправные
член: члены
илюхин: Илюхиной
команда: команды
отметить: отметить
девочка: девочки
погодя: погодя
ужаснуться: ужаснулись
выходка: выходке
отрабатывать: отрабатывать
задний: задний
ход: ход
поздновато: поздновато
родный: родные
пенаты: пенаты
прямо: прямо
просто: просто
съесть: съедят
морально: морально
хотеть: хочешь
прийтись: придтся
тащить: тащить
лямка: лямку
до: до
какойнибудь: какогонибудь
конец: конца
более: более
появление: появлением
землянин: землянина
последующий: последующими
событие: событиями
призрачный: призрачный
утереть: утереть
нос: нос
злопыхательница: злопыхательницам
должное: должное
коропетка: коропеткам
признать: признать
плохой: плохими
боец: бойцами
главный: главных
достаточно: достаточно
адекватный: адекватными
коммуникабельный: коммуникабельными
человек: людьми
готовый: готовыми
учиться: учиться
ныть: ныть
пустяк: пустякам
представлять: Представляем
внимание: вниманию
похожий: похожие
отобрать: отобрали
схожий: схожую
название: названию
смысл: смысле
литература: литературу
надежда: надежде
предоставить: предоставить
читатель: читателей
больше: больше
вариант: вариантов
интересный: интересные
обсуждение: Обсуждение
собственный: собственные
оставить: Оставьте
думать: думаете
указать: Укажите
конкретно: конкретно
понравиться: понравилось
почему: почему
считать: считаете
