заголовок: Заголовок
олег: Олег
данильченко: Данильченко
имперский: Имперский
вояж: вояж
читать: читать
онлайн: онлайн
бесплатно: бесплатно
адрес: адрес
здесь: здесь
быть: была
возможность: Возможность
весь: Вс
текст: текст
электронный: электронной
книга: книге
совершенно: совершенно
целиком: целиком
полный: полную
версия: версию
в: в
некоторый: некоторых
случай: случаях
присутствовать: присутствует
краткий: краткое
содержание: содержание
город: Город
м: М
спб: СПб
год: год
выпуск: выпуска
издательство: издательство
аста: АСТ
издательский: Издательский
дом: дом
ленинград: Ленинград
категория: категорию
боевой: Боевая
фантастика: фантастика
космический: Космическая
на: на
русский: русском
язык: языке
описание: описание
произведение: произведении
предисловие: предисловие
а: а
так: так
же: же
отзыв: отзывы
посетитель: посетителей
доступный: доступны
портал: портале
библиотека: Библиотека
либ: Либ
кат: Кат
создать: создана
для: для
любитель: любителей
полистать: полистать
хороший: лучшем
книжка: книжку
и: и
предлагать: Предлагаем
широкий: широкий
выбор: выбора
жанр: жанров
любовный: любовные
роман: романы
фэнтези: фэнтези
приключение: приключения
детектив: детективы
триллер: триллеры
эротика: эротика
документальный: документальные
научный: научные
юмористический: юмористические
анекдот: анекдоты
о: о
бизнес: бизнесе
проза: проза
детский: детские
сказка: сказки
религиия: религиии
новинка: новинки
православный: православные
старинный: старинные
про: про
компьютер: компьютеры
программирование: программирование
английский: английском
домоводство: домоводство
поэзия: поэзия
выбрав: Выбрав
по: по
душа: душе
вы: Вы
смочь: сможете
найти: Найдя
действительно: действительно
стоить: стоя
насладиться: насладиться
погружение: погружением
мир: мир
воображение: воображения
прочувствовать: прочувствовать
переживание: переживания
герой: героях
или: или
узнать: Узнайте
себя: себе
чтото: чтото
новый: новые
совершить: совершить
внутренний: внутреннее
открытие: открытие
подробный: Подробная
информация: информацию
ознакомление: ознакомления
текущий: текущему
запрос: запрос
представить: представлен
низкий: Ниже
к: к
чтение: чтение
аннотация: аннотацию
зависеть: зависит
от: от
тот: того
что: что
написать: напишите
сам: самому
автор: автора
если: если
не: не
необходимый: необходимую
комментарий: комментарии
мы: Мы
постараться: постараемся
отыскать: отыскать
она: ею
кто: кем
фамилия: фамилию
как: как
звать: зовут
список: списком
его: его
серия: сериям
уважаемые: Уважаемые
правообладатель: правообладатели
размещать: размещать
наш: нашем
сайт: сайте
у: у
любой: любой
зарегистрировать: зарегистрированного
пользователь: пользователя
ваш: ваши
опубликовать: опубликована
без: без
согласие: согласия
пожалуйста: пожалуйста
направить: направьте
жалоба: жалобу
заполните: заполните
форма: форму
обратный: обратной
связь: связи
течение: течение
час: часов
закрыть: закроем
доступ: доступ
нелегально: нелегально
разместить: размещенному
контент: контенту
разбить: разбитый
страница: страницу
система: Система
сохранение: сохранения
место: места
последний: последней
прочитать: прочитанные
позволять: позволяет
с: с
удобство: удобством
необходимость: необходимости
каждый: каждый
раз: раз
заново: заново
искать: искать
остановиться: остановились
поставить: поставил
закладка: Закладка
момент: момент
перейти: перейти
который: котором
закончить: закончил
шрифт: Шрифт
интервал: Интервал
общий: общем
после: После
небольшой: небольшого
ресторанчик: ресторанчика
где: Где
илья: Илья
съесть: съел
огромный: огромным
кусок: кусок
натуральный: натурального
очень: очень
вкусный: вкусного
мясо: мяса
он: нему
потащить: потащили
магазин: магазин
правда: Правда
джойло: Джойл
трусливо: трусливо
ретироваться: ретировался
отмазаться: Отмазался
практически: практически
вопрос: вопросы
решить: решили
то: то
теперь: теперь
они: они
справиться: справятся
срочно: срочно
должный: должен
ехать: ехать
но: Но
аэротакси: аэротакси
стеклянный: стеклянное
здание: здание
этот: этим
оказаться: оказался
торговый: торгового
центр: центра
состояться: состоялся
сказать: скажешь
шопинг: шопинг
илюха: Илюха
выбрать: выбрал
несколько: несколько
пара: пару
брюки: брюк
удобный: удобные
туфля: туфли
штука: штука
четыре: четыре
рубаха: рубахи
столько: столько
майка: маек
также: также
взять: взял
смена: смен
белье: белья
классный: классная
куртка: куртку
похожий: похожие
кожаный: кожаную
легкий: лгкую
чтобы: чтобы
это: Это
унести: унести
прикупить: прикупил
рюкзак: рюкзак
чемодан: Чемоданы
признавать: признавал
принцип: принципе
экипироваться: экипировался
быстро: быстро
энди: Энди
скорый: Скорее
прийтись: Пришлось
бы: бы
провести: провести
остаться: оставшийся
вечер: вечер
активироваться: активировавшаяся
нейросеть: нейросеть
настойчиво: настойчиво
требовать: требовала
участие: участия
отрывать: отрывать
недовольный: недовольную
девушка: девушка
приятный: приятных
дело: дел
устраиваться: устраиваться
кафешка: кафешке
спокойно: спокойно
разобраться: разобраться
помощь: помощь
подруга: подругу
настроить: настроил
интерфейс: интерфейс
первый: Первым
очередь: очередь
функция: функцию
управление: управления
банковский: банковским
счет: счта
настояние: настоянию
проплатить: проплатил
пользование: пользование
информационный: информационной
сеть: сеть
сразу: сразу
наподобие: наподобие
земной: земного
интернет: Интернета
только: только
куда: куда
масштабнее: масштабнее
тут: Тут
почтовый: почтовый
обрушиться: обрушилось
спам: спама
чуть: чуть
ум: ума
сойти: сошел
когда: Когда
начать: начала
ежесекундно: ежесекундно
сообщать: сообщать
поступать: поступающих
сообщение: сообщении
настраивать: настраивать
фильтр: фильтры
помощница: помощница
туго: туго
очистить: Очистив
почта: почту
успеть: успел
туда: туда
просочиться: просочиться
молодой: молодые
человек: люди
приняться: принялись
контакт: контакт
ну: ну
сомневаться: сомневался
потом: потом
еще: ещ
обнаружить: обнаружил
няга: Нягу
этото: этото
понятный: понятно
естественно: естественно
свой: своей
прописать: прописал
заранее: заранее
ладный: Ладно
равный: равно
отчет: отчты
отправлять: отправлять
договариваться: договаривались
большой: Больше
пока: Пока
контактировать: контактировать
гостиница: гостиницу
приехать: приехали
уже: уже
затемно: затемно
разглядывать: разглядывала
номер: номер
шепот: шпотом
пообщаться: пообщался
метрдотель: метрдотелем
самый: самый
дорогой: дорогой
угловой: угловой
балкон: балконом
три: три
день: дня
заказать: заказал
ужин: ужин
двое: двоих
восторг: восторге
хотя: Хотя
лекция: лекцию
разбазаривание: разбазаривании
деньга: денег
прочесть: прочла
добросовестно: добросовестно
плескаться: плескались
роскошный: роскошной
ванна: ванне
пить: пили
игристый: игристое
вино: вино
кувыркаться: кувыркались
кровать: кровати
размер: размером
вертолетный: вертолтную
площадка: площадку
ель: ели
снова: снова
угомониться: угомонились
под: под
утро: утро
проснуться: проснулся
спать: спала
разметать: разметав
огненный: огненные
волос: волосы
подушка: подушке
ее: Е
смуглый: смуглая
кожа: кожа
удивительный: удивительным
образ: образом
контрастировать: контрастировала
белый: белыми
простыня: простынями
настолько: настолько
восхитительный: восхитительное
зрелище: зрелище
еле: еле
сдержать: сдержал
желание: желании
обладать: обладать
прямо: прямо
сейчас: сейчас
идти: идти
ванная: ванную
принимать: принимать
холодный: холодный
душ: душ
упругий: упругими
струя: струями
вода: воды
близкий: ближайшего
учебный: учебного
база: базы
резерв: резерва
всетаки: встаки
оставить: Оставьте
заведение: заведения
заявка: заявку
обучаться: обучаться
именно: именно
там: там
водный: водные
процедура: процедуры
одеться: оделся
отправить: отправил
скоро: скоро
вернуться: вернтся
пойти: пошл
стоянка: стоянки
до: до
удаваться: удавалось
транспорт: транспортом
время: время
рулить: рулила
ничто: ничего
сложный: сложного
нет: нет
ввести: ввл
хотеть: хотел
посетить: посетить
ювелирный: ювелирными
такси: Такси
сорваться: сорвалось
понести: понесло
точка: точку
назначение: назначения
прийти: пришло
уведомление: уведомление
банк: банка
списать: списана
сумма: сумма
кредит: кредитов
оплата: оплату
за: за
общественный: общественным
красота: Красота
блин: блин
пройти: прошло
десять: десяти
минута: минут
два: две
капля: капли
давешний: давешний
совершать: совершали
бутик: бутик
торговать: торговали
украшение: украшения
войти: вошл
выйти: вышел
импозантный: импозантный
господин: господин
желать: желаете
приобрести: приобрл
да: Да
уважаемый: уважаемый
подтвердить: подтвердил
намерение: намерения
я: я
сделать: сделаем
подарок: подарок
любимый: любимой
сожаление: сожалению
понимать: понимаю
мочь: Можете
понадобиться: понадобиться
находиться: нахожусь
важно: важно
заметить: заметил
владелец: владелец
лавка: лавки
все: Вс
вид: виде
описать: описать
через: Через
полчаса: полчаса
стать: стал
обладатель: обладателем
замечательный: замечательного
кулон: кулона
сработать: сработанного
из: из
какойто: какогото
драгоценный: драгоценного
местный: местный
металл: металла
иметь: имеющего
красноватый: красноватый
оттенок: оттенок
вставить: вставленным
изумительный: изумительной
чистота: чистоты
огранка: огранки
зеленый: зелным
камень: камнем
возможный: Возможно
даже: даже
собрат: собрат
изумруд: изумруда
изящный: изящное
колечко: колечко
такой: таким
красивый: красивым
уложить: уложено
черный: чрную
коробочка: коробочку
дойти: дойти
сообщить: сообщила
входящий: входящем
представлять: Представляем
внимание: вниманию
отобрать: отобрали
схожий: схожую
название: названию
смысл: смысле
литература: литературу
надежда: надежде
предоставить: предоставить
читатель: читателей
больше: больше
вариант: вариантов
интересный: интересные
обсуждение: Обсуждение
просто: просто
собственный: собственные
мнение: мнения
думать: думаете
главный: главных
указать: Укажите
конкретно: конкретно
понравиться: понравилось
почему: почему
считать: считаете
