заголовок: Заголовок
олег: Олег
данильченко: Данильченко
имперский: Имперский
вояж: вояж
читать: читать
онлайн: онлайн
бесплатно: бесплатно
адрес: Адрес
здесь: здесь
быть: был
возможность: возможность
весь: вс
текст: текст
электронный: электронной
книга: книге
совершенно: совершенно
целиком: целиком
полный: полной
версия: версию
в: в
некоторый: некоторых
случай: случаях
присутствовать: присутствует
краткий: краткое
содержание: содержание
город: Город
м: М
спб: СПб
год: год
выпуск: выпуска
издательство: издательство
аста: АСТ
издательский: Издательский
дом: дом
ленинград: Ленинград
категория: категорию
боевой: Боевая
фантастика: фантастика
космический: Космическая
на: на
русский: русском
язык: языке
описание: описание
произведение: произведении
предисловие: предисловие
а: а
так: так
же: же
отзыв: отзывы
посетитель: посетителей
доступный: доступны
портал: портале
библиотека: Библиотека
либ: Либ
кат: Кат
создать: создана
для: для
любитель: любителей
полистать: полистать
хороший: хорошую
книжка: книжку
и: и
предлагать: Предлагаем
широкий: широкий
выбор: выбора
жанр: жанров
любовный: любовные
роман: романы
фэнтези: фэнтези
приключение: приключения
детектив: детективы
триллер: триллеры
эротика: эротика
документальный: документальные
научный: научные
юмористический: юмористические
анекдот: анекдоты
о: о
бизнес: бизнесе
проза: проза
детский: детские
сказка: сказки
религиия: религиии
новинка: новинки
православный: православные
старинный: старинные
про: про
компьютер: компьютеры
программирование: программирование
английский: английском
домоводство: домоводство
поэзия: поэзия
выбрав: Выбрав
по: по
душа: душе
вы: Вы
смочь: сможете
найти: нашли
действительно: действительно
стоить: стоящие
насладиться: насладиться
погружение: погружением
мир: мир
воображение: воображения
прочувствовать: прочувствовать
переживание: переживания
герой: героях
или: или
узнать: Узнайте
себя: себе
чтото: чтото
новый: новые
совершить: совершить
внутренний: внутреннее
открытие: открытие
подробный: Подробная
информация: информацию
ознакомление: ознакомления
текущий: текущему
запрос: запросу
представить: представлен
низкий: ниже
к: к
чтение: чтение
аннотация: аннотацию
зависеть: зависит
от: ото
тот: того
что: что
написать: напишите
сам: сам
автор: автора
если: Если
не: не
необходимый: необходимую
комментарий: комментарии
мы: Мы
постараться: постараемся
отыскать: отыскать
она: она
кто: кому
фамилия: фамилию
как: как
звать: зовут
список: списком
его: его
серия: сериям
уважаемые: Уважаемые
правообладатель: правообладатели
размещать: размещать
наш: нашем
сайт: сайте
у: у
любой: любой
зарегистрировать: зарегистрированного
пользователь: пользователя
ваш: ваши
опубликовать: опубликована
без: без
согласие: согласия
пожалуйста: пожалуйста
направить: направьте
жалоба: жалобу
заполните: заполните
форма: форму
обратный: обратной
связь: связи
течение: течение
час: часов
закрыть: закроем
доступ: доступ
нелегально: нелегально
разместить: размещенному
контент: контенту
разбить: разбитый
страница: страницу
система: Система
сохранение: сохранения
место: месте
последний: последний
прочитать: прочитанные
позволять: позволяет
с: с
удобство: удобством
необходимость: необходимости
каждый: каждый
раз: раз
заново: заново
искать: искать
остановиться: остановились
поставить: Поставьте
закладка: Закладка
момент: момент
перейти: перейти
который: которыми
закончить: закончили
шрифт: Шрифт
интервал: Интервал
однако: Однако
растяжка: растяжка
только: только
нанести: нанесла
вред: вред
здоровье: здоровью
еще: ещ
сигнал: сигнал
подать: подала
засветить: засветила
они: они
программа: программе
хоть: хоть
стараться: старается
илья: Илья
но: но
пушной: пушной
северный: северный
зверек: зверк
похоже: похоже
уже: уже
подход: подходе
илюха: Илюха
прекрасно: прекрасно
это: это
понимать: понимают
ползет: ползт
просто: просто
он: его
ползти: ползт
небольшой: небольшой
гряда: гряде
валун: валунов
неплохой: неплохой
позиция: позицию
закончиться: закончится
после: После
пережить: пережитого
бояться: боялся
умереть: умереть
собираться: собирался
жизнь: жизнь
свой: сво
продать: продать
дорогой: подороже
глава: Глава
древний: Древняя
машина: машина
все: вс
живой: живым
многий: многих
век: века
пережив: пережив
создатель: создателей
незапамятный: незапамятные
время: времена
один: одной
из: из
составлять: составляли
сеть: сеть
межгалактический: межгалактических
транспортный: транспортного
коммуникация: коммуникаций
кануть: Канула
могучий: могучая
цивилизация: цивилизация
под: под
сила: силу
зажигать: зажигать
гасить: гасить
звезда: звзды
функционировать: функционировала
правда: Правда
реактор: реактор
практически: практически
выработать: выработал
ресурс: ресурс
накопитель: накопителях
достаточно: достаточно
энергия: энергии
чтобы: чтобы
выполнить: выполнила
работа: работу
предназначить: предназначена
за: за
пройти: прошедшие
планета: планеты
сильно: сильно
измениться: изменилось
материк: материки
уйти: уйти
вода: воду
другой: другие
сдвинуться: сдвинулись
да: Да
поменять: поменяла
угол: угол
наклон: наклона
ось: оси
бесчисленный: Бесчисленное
количество: количество
катаклизм: катаклизмов
разный: разного
род: рода
пройтись: прошлись
поверхность: поверхности
земля: землей
кардинально: кардинально
менять: меняя
ее: е
облик: облик
выжить: выжила
корпус: корпус
помять: помят
иметься: имелись
трещина: трещины
местоположение: местоположение
теперь: теперь
находиться: находилась
четырнадцать: четырнадцать
метр: метрах
уровень: уровня
откуда: Откуда
знать: зная
облюбовать: облюбовал
аккурат: аккурат
над: над
модуль: модулем
транспортер: транспортера
край: Краем
попадать: попадает
зона: зону
захват: захвата
сфера: сферы
отправка: отправки
активация: активации
перенос: переноса
голос: голосом
нужный: нужно
произнести: произнес
название: названию
конечный: конечной
точка: точку
маршрут: маршрута
чех: чехов
появиться: появились
ранний: раньше
чем: чем
предполагать: предполагал
рассчитывать: рассчитывал
часполтора: часполтора
преследователь: Преследователей
буквально: буквально
минута: минут
через: через
двадцать: двадцать
видимо: видимо
истощение: истощение
слабость: слабость
сказаться: сказались
скорость: скорости
беглец: беглецов
ну: ну
ж: ж
тем: тем
лучше: лучше
сесть: сядешь
выйти: выйдешь
подумать: подумал
перевести: перевел
флажок: флажок
предохранитель: предохранителя
положение: положение
стрельба: стрельбы
короткий: короткими
очередь: очередями
много: много
гораздо: гораздо
больше: больше
вначале: вначале
прибыть: прибыло
подкрепление: подкрепление
идти: Шли
осторожно: осторожно
взрыв: взрыва
нет: нет
труп: трупов
значить: значит
кровь: крови
раненый: раненые
мочь: может
далеко: далеко
след: следы
волочение: волочения
тело: телом
видный: видны
хрен: хрен
ошибиться: ошибшься
попросту: Попросту
говорить: говоря
математик: математиком
сложить: сложить
два: двух
выбрать: выбрал
цель: цель
поход: походу
главный: главных
вон: вон
ручонка: ручонками
махать: машет
показывать: показывая
какой: какие
фланг: фланги
держать: держал
вряд: Вряд
ли: ли
успеть: успеет
положить: положить
двое: двоих
трое: троих
получиться: получится
ноль: ноль
помножить: помножить
гранатка: гранатка
слово: слово
сказать: скажет
вообщето: Вообщето
гранаткать: гранатки
смысл: смысле
капитан: капитану
этот: Эта
тварь: тварям
сдаваться: сдаваться
надо: Надо
близкий: поближе
подпустить: подпустить
наверняка: наверняка
ага: Ага
вот: вот
чутьчуть: чутьчуть
самый: самый
пора: ПОРА
тадама: Тадам
приклад: приклад
автомат: автомата
дружески: дружески
толкнуть: толкнул
плечо: плечо
старшина: старшина
боевик: боевиков
опрокинуться: опрокинулся
назад: назад
жопой: жопой
проломив: проломив
куст: кусты
до: до
такой: такое
оружие: оружие
рука: руках
слышать: слышал
попробовать: попробовав
впечатлиться: впечатлился
бы: бы
трофейный: трофейный
иголочка: иголочки
абакан: Абакан
средний: средней
дистанция: дистанции
пуля: пуль
класть: кладет
российский: российских
войско: войсках
редкость: редкость
бандос: бандосов
догадаться: догадаться
сложный: сложно
минус: Минус
сообщить: сообщил
растеряться: растерялись
несколько: несколько
секунда: секунд
ожидать: ожидали
противник: противник
оказаться: окажется
близко: близко
их: их
расчет: расчетам
должный: должна
гдето: гдето
лес: лесу
маячить: маячил
сто: ста
спина: спиной
заминка: заминка
дать: дала
сделать: сделать
результативный: результативных
попадание: попадания
тадам: тадам
двухсотый: двухсотых
потом: потом
бандит: бандиты
залечь: залегли
открыть: открыв
ураганный: ураганный
огонь: огонь
давать: давая
поднять: поднять
голова: головы
исхитриться: исхитрился
метнуть: метнуть
тяжелый: тяжелый
эфок: эфки
туда: туда
где: где
видеть: видел
особо: особо
плотный: плотную
группка: группку
удовольствие: удовольствием
услышать: услышал
испуганный: испуганные
крик: крики
звук: звуки
значит: значит
попасть: попал
продолжаться: продолжался
камень: камни
сжаться: сжался
комок: комок
прижавшись: прижавшись
содрогаться: содрогались
град: градом
ждать: ждал
скоро: скоро
обойти: обойдут
сторона: сторон
остаться: остались
выдернуть: выдернуть
кольцо: кольцо
прижаться: прижаться
граната: гранатой
сразу: сразу
сначала: сначала
магазин: магазин
патрон: патроны
пропадать: пропадать
добро: добру
красавец: красавцы
зрение: зрения
заметить: заметил
движение: движение
слева: слева
передвинуть: передвинул
отсечка: отсечки
нажать: нажал
поливать: поливай
пока: пока
опустеть: опустеет
ловить: Ловите
суукииииииия: Суукииииииии
пробудиться: пробудилась
сон: сна
глубоко: глубоко
чуткий: чуткие
датчик: датчики
уловить: уловили
знакомый: знакомую
команда: команды
координата: Координаты
суук: Суук
память: памяти
узел: узла
начаться: началась
штатный: штатная
процедура: процедура
груз: груз
великоватый: великоват
нынешний: нынешнего
состояние: состояния
бездушный: бездушная
вопрос: вопросов
задавать: задат
выполнять: выполнять
представлять: Представляем
внимание: вниманию
похожий: похожие
отобрать: отобрали
схожий: схожую
литература: литературу
надежда: надежде
предоставить: предоставить
читатель: читателей
вариант: вариантов
интересный: интересные
обсуждение: Обсуждение
собственный: собственные
мнение: мнения
оставить: Оставьте
думать: думаете
указать: Укажите
конкретно: конкретно
понравиться: понравилось
почему: почему
считать: считаете
