заголовок: Заголовок
олег: Олег
данильченко: Данильченко
имперский: Имперский
вояж: вояж
читать: читать
онлайн: онлайн
бесплатно: бесплатно
адрес: Адрес
здесь: Здесь
быть: быть
возможность: возможность
весь: вс
текст: текст
электронный: электронной
книга: книге
совершенно: совершенно
целиком: целиком
полный: полную
версия: версию
в: в
некоторый: некоторых
случай: случае
присутствовать: присутствует
краткий: краткое
содержание: содержание
город: Город
м: М
спб: СПб
год: год
выпуск: выпуска
издательство: издательство
аста: АСТ
издательский: Издательский
дом: дома
ленинград: Ленинград
категория: категорию
боевой: боевых
фантастика: фантастика
космический: Космическая
на: на
русский: русском
язык: языке
описание: описание
произведение: произведении
предисловие: предисловие
а: а
так: так
же: же
отзыв: отзывы
посетитель: посетителей
доступный: доступны
портал: портале
библиотека: Библиотека
либ: Либ
кат: Кат
создать: создана
для: для
любитель: любителей
полистать: полистать
хороший: лучшем
книжка: книжку
и: и
предлагать: Предлагаем
широкий: широкий
выбор: выбора
жанр: жанров
любовный: любовные
роман: романы
фэнтези: фэнтези
приключение: приключения
детектив: детективы
триллер: триллеры
эротика: эротика
документальный: документального
научный: научные
юмористический: юмористические
анекдот: анекдоты
о: о
бизнес: бизнесе
проза: проза
детский: детские
сказка: сказки
религиия: религиии
новинка: новинки
православный: православные
старинный: старинные
про: Про
компьютер: компьютеры
программирование: программирование
английский: английском
домоводство: домоводство
поэзия: поэзия
выбрав: Выбрав
по: по
душа: душе
вы: Вы
смочь: сможете
найти: нашли
действительно: действительно
стоить: стоит
насладиться: насладиться
погружение: погружением
мир: мира
воображение: воображения
прочувствовать: прочувствовать
переживание: переживания
герой: героях
или: или
узнать: Узнайте
себя: собой
чтото: чтото
новый: новые
совершить: совершить
внутренний: внутреннее
открытие: открытие
подробный: Подробная
информация: информацию
ознакомление: ознакомления
текущий: текущему
запрос: запросу
представить: представлен
низкий: Ниже
к: ко
чтение: чтение
аннотация: аннотацию
зависеть: зависит
от: от
тот: то
что: что
написать: напишите
сам: сама
автор: автора
если: Если
не: не
необходимый: необходимую
комментарий: комментарии
мы: Мы
постараться: постараемся
отыскать: отыскать
она: е
кто: кто
фамилия: фамилию
как: как
звать: зовут
список: списком
его: его
серия: сериям
уважаемые: Уважаемые
правообладатель: правообладатели
размещать: размещать
наш: наших
сайт: сайте
у: у
любой: любой
зарегистрировать: зарегистрированного
пользователь: пользователя
ваш: ваши
опубликовать: опубликована
без: без
согласие: согласия
пожалуйста: пожалуйста
направить: направьте
жалоба: жалобу
заполните: заполните
форма: форму
обратный: обратной
связь: связи
течение: течение
час: часов
закрыть: закроем
доступ: доступ
нелегально: нелегально
разместить: размещенному
контент: контенту
разбить: разбитый
страница: страницу
система: Система
сохранение: сохранения
место: места
последний: последний
прочитать: прочитанные
позволять: позволяет
с: с
удобство: удобством
необходимость: необходимости
каждый: каждый
раз: раз
заново: заново
искать: искать
остановиться: остановились
поставить: Поставьте
закладка: Закладка
момент: момент
перейти: перейти
который: которых
закончить: закончили
шрифт: Шрифт
интервал: Интервал
он: он
увидеть: увидел
напоминать: напоминал
кадр: кадры
фильм: фильма
падение: падения
тунгусский: Тунгусского
метеорит: метеорита
лишь: лишь
разница: разницей
повалить: поваленные
дерево: деревья
похожий: похожие
тощий: тощие
ствол: стволы
из: из
сюжет: сюжета
лежать: лежали
многовековый: многовековые
исполин: исполины
несколько: несколько
метр: метров
обхват: обхвате
ровненький: ровненько
уложить: уложенные
вокруг: вокруг
воронка: воронки
центр: центре
восседать: восседал
огромный: огромные
каменный: каменной
куча: кучу
еще: ещ
далекий: дальше
этот: эти
вакханалия: вакханалии
стена: стеной
стоять: стоял
густой: густой
лес: леса
даже: даже
отсюда: Отсюда
понятный: понятно
чужой: чужой
илья: Илья
никогда: никогда
бывать: бывало
джунгли: джунгли
хоть: хоть
темнеть: темнеющий
неподалеку: неподалеку
земной: земные
специалист: специалисту
ботаника: ботанике
ясный: ясно
божий: божий
день: день
это: Это
другой: другой
сюрреалистичный: Сюрреалистичная
картинка: картинка
получиться: получилось
ни: ни
хрена: хрена
воскликнуть: воскликнул
илюха: Илюху
голос: голос
только: только
теперь: теперь
обратить: обратил
свой: своими
внимание: вниманию
светило: светило
вставать: встававшее
над: над
багровокрасный: багровокрасный
диск: диск
иметь: имел
ничто: ничего
общий: общего
родный: родной
солнце: солнцем
ну: Ну
уж: уж
очень: очень
интересно: Интересно
девка: девки
плясать: пляшут
четыре: четыре
штука: штуки
ряд: ряд
пробормотать: пробормотал
чувствовать: чувствуя
гдето: гдето
внутри: внутри
живот: живот
подниматься: поднимается
нехороший: нехорошее
ощущение: ощущение
паника: паники
чтобы: чтобы
чечня: Чечня
земля: земле
похоже: похоже
где: где
я: мне
куда: куда
попасть: попала
вопрос: вопрос
всколыхнуть: всколыхнул
целый: целый
пласт: пласт
память: памяти
время: время
всевозможный: всевозможных
попаданец: попаданцев
эльф: эльфов
гном: гномов
магия: магию
прочий: прочее
подобный: подобное
при: при
нынешний: нынешних
обстоятельство: обстоятельствах
вполне: вполне
объяснение: объяснение
появиться: появившаяся
сейчас: сейчас
пара: пара
тройка: тройка
длинноухий: длинноухих
красавец: красавцев
лука: луками
наверно: наверно
бы: бы
удивиться: удивился
но: Но
испугаться: испугался
толком: толком
событие: события
вновь: вновь
понестись: понеслись
вскачь: вскачь
заметить: заметил
движение: движение
край: краю
там: там
принять: приняв
упасть: упавший
собрат: собратьев
выдержать: выдержали
сначала: Сначала
один: Один
человекообразный: человекообразная
фигура: фигуры
потом: потом
двенадцать: Двенадцать
существо: существ
насчитать: насчитал
инстинктивно: Инстинктивно
подхватить: подхватив
автомат: автомат
залечь: залг
за: за
самый: самыми
валун: валунами
среди: среди
вести: вел
бой: бой
хотя: хотя
технически: технически
таковой: таковую
считать: считаете
глина: глины
щебень: щебня
приближаться: Приближающиеся
фэнтезийный: фэнтезийных
персонаж: персонажей
совсем: совсем
вернее: Вернее
они: они
скорый: скорее
смахивать: смахивали
красочный: красочных
обложка: обложек
фантастический: фантастических
бронированный: бронированных
скафандр: скафандрах
футуристический: футуристическими
пушка: пушками
конечно: конечно
просто: просто
узнаваемый: узнаваемо
человек: люди
гуманоиды: гуманоиды
однозначно: однозначно
два: Две
рука: руки
нога: ноги
голова: голове
растерянность: растерянности
уже: уже
смириться: смирился
мысль: мысли
находиться: находится
далеко: далеко
туда: туда
вернуться: вернтся
делать: делать
знать: знал
сторона: стороны
точно: точно
чех: чехи
следовать: следует
принцип: принципе
враг: враг
тогда: Тогда
мочь: Может
показаться: показаться
сказать: сказано
кинуться: кинутся
распростереть: распростртыми
объятие: объятиями
местный: местный
аналог: аналог
бандос: бандосов
грохнуть: грохнут
плохой: худшем
тоже: тоже
простой: просто
вроде: вроде
предельно: предельно
делатьто: делатьто
такой: такое
роиться: роились
однако: Однако
сколько: сколько
размышлять: размышляй
эдак: эдак
надо: надо
поэтому: Поэтому
высунуться: высунулся
изза: изза
укрытие: укрытия
обозначить: обозначив
присутствие: присутствие
сразу: сразу
прийтись: пришлось
нырять: нырять
обратно: обратно
потому: Потому
реакция: реакция
появление: появление
мгновенный: мгновенной
однозначный: однозначной
цвет: цветов
ковровый: ковровой
дорожка: дорожки
духов: духовым
оркестр: оркестром
вместо: вместо
делегация: делегация
встречать: встречающих
быстро: быстро
рассыпаться: рассыпалась
цепь: цепью
вскинуть: вскинув
оружие: оружие
открыть: открыла
огонь: огня
правда: Правда
слишком: слишком
громко: громко
привычный: Привычного
грохот: грохота
пламя: пламени
дым: дыма
сгорать: сгорающего
порох: пороха
помин: помине
негромкий: негромкий
треск: треск
вот: вот
шквал: шквал
смертоносный: смертоносных
снаряд: снарядов
обрушиться: обрушившийся
многострадальный: многострадальные
камень: камни
наоборот: наоборот
впечатляющий: впечатляющим
организм: Организм
щедро: щедро
впрыснуть: впрыснул
адреналин: адреналин
кровь: кровь
ж: ж
повашему: повашему
нна: Нна
тадам: тадам
нападать: Нападавшие
сесть: сел
задница: задницу
очередь: очереди
абакан: Абакана
хухрамухра: хухрымухры
добросовестно: добросовестно
скончаться: скончаться
быстренько: быстренько
подскочить: подскочил
ломануться: ломанулся
сайгак: сайгак
кукуруза: кукурузе
еп: Еп
пический: пическая
сила: сила
воевать: воевать
попадание: попадания
слон: слону
дробина: дробина
видимо: видимо
понять: поняли
стать: стало
заметный: заметно
перестать: перестали
изменять: изменять
ландшафт: ландшафт
трещотка: трещотками
начать: начали
обходить: обходить
пытаться: пытаясь
взять: взять
клещ: клещи
ладно: Ладно
черт: черт
отсутствие: Отсутствие
дать: дало
хорошо: хорошо
прицелиться: прицелиться
послать: послать
граната: гранату
под: под
противник: противнику
вог: ВОГ
подвести: подвела
смысл: смысле
примерно: примерно
бабахнуть: бабахнула
ожидаться: ожидалось
пронять: Проняло
опять: опять
ненадолго: ненадолго
взрывной: Взрывной
волна: волной
трое: троих
гаврик: гавриков
раскидать: раскидало
разный: разные
ехидный: ехидная
улыбка: улыбка
сползти: сползла
илюхин: Илюхиного
лицо: лица
когда: когда
сволочь: сволочи
наплевать: наплевав
должный: должны
убить: убиты
бодренько: бодренько
подняться: поднялись
потрусить: потрусили
представлять: Представляем
отобрать: отобрали
схожий: схожую
название: названию
литература: литературу
надежда: надежде
предоставить: предоставить
читатель: читателей
больше: больше
вариант: вариантов
интересный: интересные
обсуждение: Обсуждение
собственный: собственные
мнение: мнения
оставить: Оставьте
думать: думаете
главный: главных
указать: Укажите
конкретно: конкретно
понравиться: понравилось
нет: нет
почему: почему
