заголовок: Заголовок
олег: Олег
данильченко: Данильченко
имперский: Имперский
вояж: вояж
читать: читать
онлайн: онлайн
бесплатно: бесплатно
адрес: Адрес
здесь: Здесь
быть: будут
возможность: Возможность
весь: всем
текст: текст
электронный: электронной
книга: книге
совершенно: совершенно
целиком: целиком
полный: полную
версия: версию
в: в
некоторый: некоторых
случай: случае
присутствовать: присутствует
краткий: краткое
содержание: содержание
город: Город
м: М
спб: СПб
год: год
выпуск: выпуска
издательство: издательство
аста: АСТ
издательский: Издательский
дом: дом
ленинград: Ленинград
категория: категорию
боевой: боевом
фантастика: фантастика
космический: Космическая
на: на
русский: русском
язык: языке
описание: описание
произведение: произведении
предисловие: предисловие
а: а
так: так
же: же
отзыв: отзывы
посетитель: посетителей
доступный: доступны
портал: портале
библиотека: Библиотека
либ: Либ
кат: Кат
создать: создана
для: для
любитель: любителей
полистать: полистать
хороший: Хорошо
книжка: книжку
и: и
предлагать: Предлагаем
широкий: широкий
выбор: выбора
жанр: жанров
любовный: любовные
роман: романы
фэнтези: фэнтези
приключение: приключения
детектив: детективы
триллер: триллеры
эротика: эротика
документальный: документальные
научный: научные
юмористический: юмористические
анекдот: анекдоты
о: о
бизнес: бизнесе
проза: проза
детский: детские
сказка: сказки
религиия: религиии
новинка: новинки
православный: православные
старинный: старинные
про: про
компьютер: компьютеры
программирование: программирование
английский: английском
домоводство: домоводство
поэзия: поэзия
выбрав: Выбрав
по: по
душа: душе
вы: Вы
смочь: сможете
найти: нашли
действительно: действительно
стоить: стоите
насладиться: насладиться
погружение: погружением
мир: мир
воображение: воображения
прочувствовать: прочувствовать
переживание: переживания
герой: героях
или: или
узнать: узнать
себя: себя
чтото: чмто
новый: новые
совершить: совершить
внутренний: внутреннее
открытие: открытие
подробный: Подробная
информация: информации
ознакомление: ознакомления
текущий: текущему
запрос: запросу
представить: Представьте
низкий: Ниже
к: к
чтение: чтение
аннотация: аннотацию
зависеть: зависит
от: от
тот: то
что: что
написать: напишите
сам: само
автор: автора
если: если
не: не
необходимый: необходимую
комментарий: комментарии
мы: Мы
постараться: постараемся
отыскать: отыскать
она: е
кто: Кто
фамилия: фамилию
как: как
звать: зовут
список: списком
его: его
серия: сериям
уважаемые: Уважаемые
правообладатель: правообладатели
размещать: размещать
наш: нашем
сайт: сайте
у: у
любой: любом
зарегистрировать: зарегистрировали
пользователь: пользователя
ваш: ваши
опубликовать: опубликована
без: без
согласие: согласия
пожалуйста: пожалуйста
направить: направьте
жалоба: жалобу
заполните: заполните
форма: форму
обратный: обратной
связь: связи
течение: течение
час: часов
закрыть: закроем
доступ: доступ
нелегально: нелегально
разместить: размещенному
контент: контенту
разбить: разбитый
страница: страницу
система: Система
сохранение: сохранения
место: место
последний: последней
прочитать: прочитанные
позволять: позволяет
с: с
удобство: удобством
необходимость: необходимости
каждый: каждый
раз: разу
заново: заново
искать: искать
остановиться: остановились
поставить: поставил
закладка: Закладка
момент: момент
перейти: перейти
который: который
закончить: Закончив
шрифт: Шрифт
интервал: Интервал
ладный: Ладно
уговорить: уговорили
сколько: Сколько
боеприпас: боеприпасом
идти: идт
комплект: комплекте
один: одного
магазин: магазине
вставляться: вставляется
рукоять: рукоять
также: также
батарея: батареи
но: но
ведь: Ведь
собираться: собираетесь
много: много
стрелять: стрелять
верно: верно
этот: этой
хватить: хватит
чтобы: чтобы
успокоить: успокоить
шестьдесят: шестьдесят
человек: человек
думать: думаете
прийтись: придтся
это: Это
делать: делать
день: день
всегда: всегда
мочь: Может
пополнить: пополнить
запас: запас
боепитание: Боепитание
другой: других
торговать: торгующем
ручной: ручным
оружие: оружия
кстати: Кстати
хотеть: хотите
я: Я
заменить: заменить
причитаться: причитающуюся
скидка: скидку
дополнительный: дополнительное
впоследствии: впоследствии
выяснить: выяснил
илья: Илья
более: более
емкий: мко
термин: термин
нежели: нежели
земля: Земле
такой: таком
тоже: тоже
иметь: имели
он: он
скорый: скорее
являться: являются
синоним: синонимом
содружество: Содружестве
пониматься: понимается
сюда: Сюда
входить: входят
только: только
снаряд: снаряды
посылать: посылаемые
цель: цель
энергия: энергии
очень: очень
технологичный: технологичное
поэтому: Поэтому
работать: работает
электричество: электричестве
чисто: чисто
энергетический: энергетическое
например: например
стайер: стайер
то: то
уже: уже
питать: питающим
элемент: элементом
типа: типа
привычный: привычной
батарейка: батарейки
становиться: становятся
мощность: мощность
емкость: мкости
испускать: испускаемого
разряд: разрядов
количество: количество
немаловажный: немаловажно
отличный: Отлично
тогда: Тогда
давать: давайте
оформлять: оформлять
согласиться: согласился
через: через
десять: десять
минута: минут
стать: стал
обладатель: обладателем
собственный: собственные
оказаться: оказалось
иметься: имеется
еще: ещ
кобура: кобура
ношение: ношения
пояс: пояс
отделение: отделениями
запасный: запасного
честно: честно
говорить: говорил
просто: просто
забыть: забыл
сразу: сразу
имя: имя
настроить: настроили
нейросеть: нейросеть
когда: Когда
процедура: процедура
регистрация: регистрации
настройка: настройки
завершить: завершена
достать: достал
игольник: игольник
попробовать: попробовать
лежать: лежит
рука: руках
готовый: готовое
бой: бою
чуть: чуть
выронить: выронил
удивление: удивления
взяться: взялся
за: за
перед: перед
глаз: глазами
промелькнуть: промелькнуло
сообщение: сообщение
активировать: Активирована
функция: функции
стрельба: стрельбы
стандартный: стандартный
сто: сто
процент: процентов
состояние: состояние
активация: активации
прицельный: прицельная
сетка: сетка
требоваться: требуется
разрешение: разрешение
да: Да
нет: нет
усилие: Усилием
воля: воли
илюха: Илюха
заставить: заставил
сдержать: сдержать
эмоция: эмоции
перелопатить: перелопатил
до: до
ни: ни
слышать: слышал
нейросетисимбионт: нейросетисимбионты
скафандр: скафандре
джойло: Джойл
пока: пока
доводиться: доводилось
надо: Надо
поспрашивать: поспрашивать
потом: потом
прояснить: прояснить
лопух: лопух
остальной: остальных
задача: задачу
нормально: нормально
разобраться: разобраться
надпись: надписи
загораживать: загораживающие
обзор: обзор
напрягать: напрягают
интересный: интересные
способ: способы
общение: общения
кроме: кроме
всплывать: всплывающих
подсказка: подсказок
подумать: подумать
мыслесвязь: мыслесвязи
раздаться: раздался
прямо: прямо
голова: голове
какойто: какойто
безжизненный: безжизненный
голос: голос
серьезный: серьезное
испытание: испытание
психика: психики
нарезной: нарезным
батон: батон
вдруг: вдруг
ктото: ктото
начинать: начинает
разговаривать: разговаривал
удержите: удержите
начать: начнте
озираться: озираться
окружающие: окружающие
обращать: обращают
внимание: вниманию
продолжать: продолжает
сходить: сходите
ум: ума
испугаться: испугаться
вот: Вот
струхнуть: струхнул
маленько: маленько
все: вс
подготовить: подготовленным
подобный: подобному
знать: знаю
свой: своего
среднестатистический: среднестатистический
землянин: землянин
мысленно: мысленно
сказать: сказал
стоп: Стоп
изменение: изменения
статус: статуса
сеть: сети
закрепить: закрепим
после: после
принять: Принято
прошелестело: прошелестело
ответ: ответ
вернуть: вернул
слава: Слава
бог: богу
никто: никто
обратить: обратил
норк: Норк
продавец: продавцом
поблизости: поблизости
наблюдаться: наблюдалось
дело: дела
новоиспеченный: новоиспеченные
друг: друзья
отправиться: отправились
обзорка: обзорку
путь: пути
решить: решил
осторожно: осторожно
расспросить: расспросить
спутник: спутника
интересовать: интересующих
вопрос: вопрос
слушать: Слушай
риго: Риго
мерка: меркам
дикий: дикий
многое: многого
даже: даже
общий: общие
база: базы
знание: знаний
сегодня: сегодня
изучение: изучение
хотеться: хотелось
бы: бы
коекакой: коекакие
вещь: вещи
спрашивать: Спрашивай
считать: считаете
разбираться: разбирающимся
исключение: исключения
рассказать: расскажу
спасибо: Спасибо
дружище: дружище
первый: первый
при: при
использование: использовании
разве: разве
должный: должна
появляться: появляться
пользоваться: пользоваться
ты: ты
удивиться: удивился
собеседник: собеседник
зачем: зачем
встраивать: встраивать
они: Они
дорогой: дорогие
лишний: лишние
тормозить: тормозить
быстродействие: быстродействие
представлять: Представляем
похожий: похожие
отобрать: отобрали
схожий: схожую
название: названию
смысл: смысле
литература: литературу
надежда: надежде
предоставить: предоставить
читатель: читателей
больше: больше
вариант: вариантов
обсуждение: Обсуждение
мнение: мнения
оставить: Оставьте
главный: главных
указать: Укажите
конкретно: конкретно
понравиться: понравилось
почему: почему
