заголовок: Заголовок
олег: Олег
данильченко: Данильченко
имперский: Имперский
вояж: вояж
читать: читать
онлайн: онлайн
бесплатно: бесплатно
адрес: Адрес
здесь: Здесь
быть: быть
возможность: возможность
весь: вс
текст: текст
электронный: электронной
книга: книге
совершенно: совершенно
целиком: целиком
полный: полную
версия: версию
в: в
некоторый: некоторых
случай: случаях
присутствовать: присутствует
краткий: краткое
содержание: содержание
город: Город
м: М
спб: СПб
год: год
выпуск: выпуска
издательство: издательство
аста: АСТ
издательский: Издательский
дом: дома
ленинград: Ленинград
категория: категория
боевой: Боевая
фантастика: фантастика
космический: космический
на: на
русский: русском
язык: языке
описание: описание
произведение: произведении
предисловие: предисловие
а: а
так: так
же: же
отзыв: отзывы
посетитель: посетителей
доступный: доступны
портал: портале
библиотека: Библиотека
либ: Либ
кат: Кат
создать: создана
для: для
любитель: любителей
полистать: полистать
хороший: хорошую
книжка: книжку
и: и
предлагать: Предлагаем
широкий: широкий
выбор: выбора
жанр: жанров
любовный: любовные
роман: романы
фэнтези: фэнтези
приключение: приключения
детектив: детективы
триллер: триллеры
эротика: эротика
документальный: документальные
научный: научные
юмористический: юмористические
анекдот: анекдоты
о: о
бизнес: бизнесе
проза: проза
детский: детские
сказка: сказки
религиия: религиии
новинка: новинки
православный: православные
старинный: старинные
про: про
компьютер: компьютеры
программирование: программирование
английский: английском
домоводство: домоводство
поэзия: поэзия
выбрав: Выбрав
по: по
душа: душе
вы: Вы
смочь: сможете
найти: нашли
действительно: действительно
стоить: стоит
насладиться: насладиться
погружение: погружением
мир: мир
воображение: воображения
прочувствовать: прочувствовать
переживание: переживания
герой: героях
или: или
узнать: Узнайте
себя: себе
чтото: чтото
новый: новые
совершить: совершить
внутренний: внутреннее
открытие: открытием
подробный: Подробная
информация: информацию
ознакомление: ознакомления
текущий: текущему
запрос: запросу
представить: представлен
низкий: Ниже
к: К
чтение: чтение
аннотация: аннотацию
зависеть: зависит
от: От
тот: тем
что: что
написать: напишите
сам: самом
автор: автора
если: если
не: не
необходимый: необходимую
комментарий: комментарии
мы: Мы
постараться: постараемся
отыскать: отыскать
она: она
кто: Кто
фамилия: фамилию
как: как
звать: зовут
список: списком
его: его
серия: сериям
уважаемые: Уважаемые
правообладатель: правообладатели
размещать: размещать
наш: нашем
сайт: сайте
у: у
любой: любые
зарегистрировать: зарегистрированного
пользователь: пользователя
ваш: ваши
опубликовать: опубликована
без: без
согласие: согласия
пожалуйста: пожалуйста
направить: направьте
жалоба: жалобу
заполните: заполните
форма: форму
обратный: обратной
связь: связи
течение: течение
час: часов
закрыть: закроем
доступ: доступ
нелегально: нелегально
разместить: размещенному
контент: контенту
разбить: разбитый
страница: страницу
система: Система
сохранение: сохранения
место: места
последний: последней
прочитать: прочитанные
позволять: позволяет
с: с
удобство: удобством
необходимость: необходимости
каждый: Каждая
раз: раз
заново: заново
искать: искать
остановиться: остановились
поставить: Поставьте
закладка: Закладка
момент: момент
перейти: перейти
который: которой
закончить: закончил
шрифт: Шрифт
интервал: Интервал
я: я
еще: ещ
такой: таким
энерговооруженность: энерговооруженностью
энергопотребление: энергопотреблением
вылезать: вылезает
главный: главных
проблема: проблему
корабль: Корабль
земной: земные
слово: слова
тоже: тоже
это: это
избыток: избыток
выделять: выделяемого
тепло: тепла
нужный: нужно
избавляться: избавляться
както: както
космос: Космос
вакуум: Вакуум
чтоб: чтоб
он: он
пусто: пусто
стать: станет
простить: Простите
за: за
каламбур: каламбур
тут: тут
вообще: вообще
получаться: получается
парадокс: парадокс
являться: является
одновременно: одновременно
холодный: холодный
горячий: горячим
но: но
становиться: становится
только: только
под: под
воздействие: воздействием
светило: светила
земля: Земли
солнце: Солнце
там: там
куда: куда
доставать: достат
излучение: излучения
звезда: звезды
вот: вот
содружество: Содружество
приходиться: приходится
передвигаться: передвигаться
висеть: висеть
орбита: орбите
частый: чаще
вид: вида
изначально: Изначально
абориген: аборигенов
мучиться: мучились
ученый: ученые
потом: потом
изобрести: изобретн
силовой: силовой
щит: щит
один: один
из: из
свойство: свойств
защита: защита
избавиться: избавились
оставаться: Остается
второй: вторая
сбросить: сбросить
лишний: лишнее
да: Да
сбрасывать: сбрасывает
при: при
помощь: помощи
придумать: придуманы
называть: называемые
радиационный: радиационной
панель: панели
радиация: радиация
бояться: боятся
применительно: применительно
понятие: понятию
размещаться: размещаются
корпус: корпусе
доставляться: доставляется
они: они
сбрасываться: сбрасывается
посредством: посредством
окружать: окружающее
пространство: пространства
снаружи: снаружи
плоский: плоские
много: много
занимать: занимала
внутри: внутри
установка: Установка
охлаждение: охлаждения
достаточно: достаточно
громоздкий: громоздкие
заря: заре
освоение: освоения
через: через
врата: врата
древний: древних
основный: основным
охлаждать: охлаждающего
агент: агентом
воздух: воздух
охлаждаться: охлаждаются
помещение: помещений
оборудование: оборудование
очень: очень
уж: уж
кстати: Кстати
советский: советские
станция: станции
венера: Венера
иметь: иметь
именно: именно
воздушный: Воздушное
оставить: Оставьте
время: времена
этот: Этот
громоздкость: громоздкость
просто: просто
бич: бичом
конструктор: конструкторов
ведь: ведь
слишком: слишком
полезный: полезного
почесав: Почесав
тыква: тыкву
инженер: инженеры
решить: решили
путь: путм
использование: использования
эффект: эффекта
испарение: испарения
примерно: Примерно
холодильник: холодильнике
кухня: кухне
жидкий: Жидкий
газ: газ
попадать: попадая
обвязка: обвязку
контур: контура
совместительство: совместительству
испаритель: испарителем
резко: резко
испаряться: испаряется
естественно: естественно
приводить: приводит
отбор: отбору
дело: деле
после: после
проходить: проходит
компрессор: компрессор
вновь: вновь
превращаться: превращаясь
жидкость: жидкость
использоваться: используется
прибор: приборы
расположить: расположенных
смысл: смысле
уже: уже
обычный: обычным
способ: способов
совмещение: Совмещение
два: два
дать: дало
значительно: значительно
уменьшить: уменьшить
габарит: габариты
записывать: Записываем
пункт: пункт
ладный: Ладно
чтобы: чтобы
пудрить: пудрить
мозг: мозги
читатель: читателей
сказать: сказано
весьма: весьма
сложный: сложная
машина: машина
хотя: хотя
вряд: вряд
ли: ли
высказывание: высказывание
ктото: когото
добавить: Добавим
перечислить: перечисленные
позиция: позиции
маленький: маленькой
часть: частью
чем: чем
нафаршировать: нафарширован
реальность: реальности
вооружение: вооружение
ни: ни
план: плане
умерщвление: умерщвления
подобный: подобным
недалеко: недалеко
уйти: ушло
фантазия: Фантазия
местный: местных
тема: тему
менее: менее
буйный: буйная
сегодняшний: сегодняшний
день: день
иметься: имеется
несколько: несколько
артиллерийский: артиллерийскому
лазерный: лазерное
плазменный: плазменное
ракетный: ракетное
делиться: Делится
отдельный: отдельные
тип: тип
относиться: относится
кидаться: кидается
противник: противника
какойлибо: какоголибо
снаряд: снарядами
важный: важно
какой: какого
калибр: калибра
выстрел: выстрела
цель: цель
полететь: полетела
болванка: болванку
ближний: ближнего
бой: боя
дальнобойный: дальнобойное
вооружить: вооруженный
образ: образом
должный: должен
вместительный: вместительные
погреб: погреба
запас: запас
боеприпас: Боеприпасы
темнокожий: Темнокожий
народ: народ
обычно: обычно
свой: свои
репертуар: репертуаре
папуас: Папуасу
лишь: лишь
бы: бы
чегонибудь: чегонибудь
метнуть: метнуть
хотеть: хочешь
копье: копь
поэтому: поэтому
вариант: вариантов
отчегото: отчегото
близкий: ближе
наверное: Наверное
копия: копий
нет: нет
наличие: наличии
видимо: видимо
исходить: исходя
пристрастие: пристрастий
артиллерия: артиллерия
особенно: особенно
широко: широко
применяться: применяется
среди: среди
республиканец: республиканцев
манти: Манти
оно: оно
особо: особо
распинаться: распинаться
однако: однако
нюанс: нюансы
подавлять: подавляющем
большинство: большинстве
мгновенный: мгновенного
действие: действия
световой: светового
луч: луча
другой: другие
лазерто: лазерыто
бывать: бывают
разный: разные
ты: тебя
увернуться: уверншься
требоваться: требуются
несомненно: несомненно
плюс: плюсом
фокусировать: фокусирующих
элемент: элементов
сильно: сильно
большой: большой
нечасто: нечасто
выходить: выходят
строй: строя
прожорливый: прожорлив
потребление: потребления
энергия: энергии
невзирая: Невзирая
элента: Эленте
считать: считаете
будущее: будущее
оружие: оружием
раса: расы
пока: пока
оченьто: оченьто
спешить: спешат
верить: верить
представлять: Представляем
внимание: вниманию
похожий: похожие
отобрать: отобрали
схожий: схожую
название: названию
литература: литературу
надежда: надежде
предоставить: предоставить
больше: больше
интересный: интересные
обсуждение: Обсуждение
собственный: собственные
мнение: мнения
думать: думаете
указать: Укажите
конкретно: конкретно
понравиться: понравилось
почему: почему
