заголовок: Заголовок
олег: Олег
данильченко: Данильченко
имперский: Имперский
вояж: вояж
читать: читает
онлайн: онлайн
бесплатно: бесплатно
адрес: Адрес
здесь: Здесь
быть: Будем
возможность: возможностями
весь: Вс
текст: текст
электронный: электронной
книга: книге
совершенно: совершенно
целиком: целиком
полный: полную
версия: версию
в: в
некоторый: некоторых
случай: случае
присутствовать: присутствует
краткий: краткое
содержание: содержание
город: Город
м: М
спб: СПб
год: год
выпуск: выпуска
издательство: издательство
аста: АСТ
издательский: Издательский
дом: дом
ленинград: Ленинград
категория: категорию
боевой: Боевая
фантастика: фантастика
космический: Космическая
на: на
русский: русском
язык: языком
описание: описание
произведение: произведении
предисловие: предисловие
а: а
так: так
же: же
отзыв: отзывы
посетитель: посетителей
доступный: доступны
портал: портале
библиотека: Библиотека
либ: Либ
кат: Кат
создать: создать
для: для
любитель: любителей
полистать: полистать
хороший: Лучше
книжка: книжку
и: и
предлагать: Предлагаем
широкий: широкий
выбор: выбора
жанр: жанров
любовный: любовные
роман: романы
фэнтези: фэнтези
приключение: приключения
детектив: детективы
триллер: триллеры
эротика: эротика
документальный: документальные
научный: научные
юмористический: юмористические
анекдот: анекдоты
о: о
бизнес: бизнесе
проза: проза
детский: детские
сказка: сказки
религиия: религиии
новинка: новинки
православный: православные
старинный: старинные
про: про
компьютер: компьютеры
программирование: программирование
английский: английском
домоводство: домоводство
поэзия: поэзия
выбрав: Выбрав
по: по
душа: душе
вы: Вы
смочь: сможешь
найти: нашл
действительно: действительно
стоить: стоящие
насладиться: насладиться
погружение: погружением
мир: мир
воображение: воображения
прочувствовать: прочувствовать
переживание: переживания
герой: героях
или: или
узнать: Узнайте
себя: себе
чтото: Чтото
новый: новые
совершить: совершить
внутренний: внутреннее
открытие: открытие
подробный: Подробная
информация: информацию
ознакомление: ознакомления
текущий: текущему
запрос: Запрос
представить: представил
низкий: Ниже
к: к
чтение: чтение
аннотация: аннотацию
зависеть: зависит
от: от
тот: то
что: что
написать: напишите
сам: сам
автор: автора
если: Если
не: не
необходимый: необходимую
комментарий: комментарии
мы: Мы
постараться: постараемся
отыскать: отыскать
она: она
кто: кому
фамилия: фамилию
как: как
звать: звать
список: списком
его: его
серия: сериям
уважаемые: Уважаемые
правообладатель: правообладатели
размещать: размещать
наш: нашими
сайт: сайте
у: у
любой: Любой
зарегистрировать: зарегистрированного
пользователь: пользователь
ваш: ваши
опубликовать: опубликована
без: без
согласие: согласия
пожалуйста: пожалуйста
направить: направьте
жалоба: жалобу
заполните: заполните
форма: форму
обратный: обратной
связь: связи
течение: течение
час: часов
закрыть: закроем
доступ: доступа
нелегально: нелегально
разместить: размещенному
контент: контенту
разбить: разбитый
страница: страницу
система: Система
сохранение: сохранения
место: места
последний: последней
прочитать: прочитанные
позволять: позволяет
с: с
удобство: удобством
необходимость: необходимости
каждый: каждый
раз: раз
заново: заново
искать: ищи
остановиться: остановились
поставить: Поставьте
закладка: Закладка
момент: момент
перейти: перейти
который: которой
закончить: закончили
шрифт: Шрифт
интервал: Интервал
вот: Вот
это: этого
я: я
бояться: боюсь
илио: Илио
ты: тебе
солдат: солдат
привыкнуть: привыкли
убивать: убивать
нужный: нужную
рука: рука
дрогнуть: дрогнет
очень: очень
плохой: плохо
тогда: Тогда
уже: уже
ничто: ничего
помочь: поможет
пришьют: Пришьют
превышение: превышение
мера: мер
самооборона: самообороны
законопатить: законопатят
каторга: каторгу
до: до
конец: конца
день: дней
парализующих: парализующих
иголка: иголок
за: за
глаз: глаза
хватить: хватит
спокойней: спокойней
знать: знаю
сколько: сколько
отставник: отставников
попасться: попалось
они: ими
просто: просто
действовать: действуют
учить: учили
но: но
никто: никого
волновать: волнует
энди: Энди
переживать: переживай
учесть: учту
успокоить: успокоил
девушка: девушки
илюха: Илюха
положительный: положительную
сторона: сторону
пока: Пока
занять: занят
этот: этот
ребятки: ребятками
нет: нет
время: время
замечать: замечать
красивый: красивым
ой: Ой
испугать: испугать
самый: самая
маленький: маленькая
проблема: проблема
приехать: Приеду
округ: округе
повыдергиваю: повыдергиваю
нога: ноги
всегото: всегото
дело: дел
знакомец: знакомцами
волноваться: волнуйся
порядок: порядке
обещать: обещаю
осторожный: осторожен
кстати: Кстати
много: много
курс: курсе
еще: ещ
толком: толком
видеть: видел
присяга: Присяга
только: только
завтра: завтра
там: там
посмотреть: посмотрю
надо: надо
пожалеть: пожалей
их: их
здоровье: здоровье
да: Да
любимый: любимой
кроме: Кроме
значить: Значит
другой: Другие
мочь: можешь
понадобиться: понадобиться
такой: такой
ключ: ключе
проболтать: проболтали
отбой: отбоя
потом: потом
сказать: сказала
прийти: пришло
подвахту: подвахту
заступать: заступать
отключиться: отключилась
пора: Пора
отбиваться: отбиваться
прежде: прежде
чем: чем
сделать: сделать
он: он
решить: решил
разобраться: разобраться
вновь: вновь
открытый: открытыми
нейросеть: нейросеть
эй: Эй
тут: тут
мысленно: мысленно
позвать: позвал
умнее: умнее
придумать: придумав
неясный: неясен
прошелестеть: прошелестело
ответ: ответ
можно: Можно
сменить: сменить
голос: голос
выбрать: Выберите
модуляция: модуляцию
предоставить: предоставить
погоди: погоди
свой: своим
разговаривать: разговаривал
ее: е
использовать: использовать
принять: Принято
ответить: ответила
намного: намного
лучше: лучше
теперь: теперь
обращение: обращений
называть: называть
какойнибудь: какиенибудь
вариант: вариантов
буквенноцифровой: Буквенноцифровую
аббревиатура: аббревиатуру
назначить: назначить
приемлемый: приемлемый
отличный: Отлично
говорить: говоришь
то: то
имя: именем
ди: Ди
запутаться: запутаюсь
самоназвание: самоназвание
прописать: прописано
корневой: корневую
папка: папку
оставить: Оставьте
общий: общего
зафиксировать: Зафиксировано
слушать: Слушай
както: както
менее: менее
официальный: официальным
любить: люблю
казенщина: казенщины
активировать: Активировать
имитация: имитация
разумный: разумного
существо: существа
функция: функцией
обучение: обучения
готовый: Готово
обучаться: обучаться
запоминать: запоминая
речевой: речевые
оборот: обороты
чтобы: чтобы
дальнейший: дальнейшем
пользоваться: пользоваться
желать: Желает
ли: ли
впредь: впредь
позиционировать: позиционировала
женский: женского
пол: пола
являться: Является
поведение: поведения
живой: живого
под: под
приоритетный: приоритетным
конечно: Конечно
второй: Вторую
выдержать: выдержу
расхохотаться: расхохотался
более: более
упростить: упрощенный
анализировать: Анализирую
устроить: устроит
работа: работе
счастие: Счастье
мой: моя
горе: Горе
гад: Гад
сволочь: Сволочь
бабник: Бабник
мужлан: Мужлан
дикарь: Дикарь
бестолочь: Бестолочь
затараторить: затараторила
точность: точности
повторять: повторяя
интонация: интонации
из: из
эпитет: эпитетов
аж: аж
поперхнуться: поперхнулся
какой: Какое
предпочтительно: предпочтительно
ни: ни
один: одну
подходить: подходит
должный: должен
босс: босс
ж: ж
вроде: вроде
командовать: командую
давать: давай
договориться: Договорились
прозвучать: прозвучал
легкий: легкой
язвинка: язвинкой
хотеть: хотел
напомнить: напомнить
отложить: отложил
активация: активацию
оружейный: оружейной
чуть: чуть
обиженно: обиженно
даже: даже
надутый: надутые
губка: губки
продолжить: Продолжим
ведь: ведь
ексельмоксель: ксельмоксель
подумать: подумал
восхищение: восхищением
стараться: старался
похоже: похоже
язва: язвой
заполучить: заполучил
илья: Илье
послышаться: послышались
обиженноугрожающий: обиженноугрожающие
изменить: изменить
ох: Ох
еооо: ооо
мысль: мысли
поспешить: поспешил
поправиться: поправиться
все: вс
надеяться: Надеюсь
твой: твои
желание: желания
чувствовать: чувствую
эмоция: эмоции
поступать: поступаю
бы: бы
насколько: Насколько
понимать: понимаю
нравиться: нравится
настраивать: настраивать
естественно: Естественно
представлять: Представляем
внимание: вниманию
похожий: похожие
отобрать: отобрали
схожий: схожую
название: названию
смысл: смысле
литература: литературу
надежда: надежде
читатель: читателей
больше: больше
интересный: интересные
обсуждение: Обсуждение
собственный: собственные
мнение: мнения
думать: думаете
главный: главных
указать: Укажите
конкретно: конкретно
понравиться: понравилось
почему: почему
считать: считаете
