заголовок: Заголовок
олег: Олег
данильченко: Данильченко
имперский: Имперский
вояж: вояж
читать: читать
онлайн: онлайн
бесплатно: бесплатно
адрес: Адрес
здесь: Здесь
быть: были
возможность: Возможность
весь: всех
текст: текст
электронный: электронной
книга: книге
совершенно: совершенно
целиком: целиком
полный: полную
версия: версию
в: в
некоторый: некоторых
случай: случае
присутствовать: присутствуют
краткий: краткое
содержание: содержание
город: Город
м: М
спб: СПб
год: год
выпуск: выпуска
издательство: издательство
аста: АСТ
издательский: Издательский
дом: дом
ленинград: Ленинград
категория: категорию
боевой: Боевая
фантастика: фантастика
космический: Космическая
на: на
русский: русском
язык: языке
описание: описание
произведение: произведении
предисловие: предисловие
а: а
так: так
же: же
отзыв: отзывы
посетитель: посетителей
доступный: доступны
портал: портале
библиотека: Библиотека
либ: Либ
кат: Кат
создать: создана
для: для
любитель: любителей
полистать: полистать
хороший: хорошую
книжка: книжку
и: и
предлагать: Предлагаем
широкий: широкий
выбор: выбора
жанр: жанров
любовный: любовные
роман: романы
фэнтези: фэнтези
приключение: приключений
детектив: детективы
триллер: триллеры
эротика: эротика
документальный: документальные
научный: научные
юмористический: юмористические
анекдот: анекдоты
о: о
бизнес: бизнесе
проза: проза
детский: детские
сказка: сказки
религиия: религиии
новинка: новинки
православный: православные
старинный: старинные
про: про
компьютер: компьютеры
программирование: программирование
английский: английском
домоводство: домоводство
поэзия: поэзия
выбрав: Выбрав
по: по
душа: душе
вы: Вы
смочь: сможете
найти: нашли
действительно: действительно
стоить: стоящие
насладиться: насладиться
погружение: погружением
мир: мир
воображение: воображения
прочувствовать: прочувствовать
переживание: переживания
герой: героях
или: или
узнать: Узнайте
себя: себя
чтото: чтото
новый: новые
совершить: совершить
внутренний: внутреннее
открытие: открытие
подробный: Подробная
информация: информацию
ознакомление: ознакомления
текущий: текущему
запрос: запросу
представить: представлен
низкий: Ниже
к: к
чтение: чтение
аннотация: аннотацию
зависеть: зависит
от: от
тот: то
что: что
написать: напишите
сам: сама
автор: автора
если: если
не: не
необходимый: необходимую
комментарий: комментарии
мы: Мы
постараться: постараемся
отыскать: отыскать
она: она
кто: кого
фамилия: фамилию
как: как
звать: зовут
список: списком
его: его
серия: сериям
уважаемые: Уважаемые
правообладатель: правообладатели
размещать: размещать
наш: нашем
сайт: сайте
у: у
любой: любом
зарегистрировать: зарегистрированного
пользователь: пользователя
ваш: ваши
опубликовать: опубликована
без: без
согласие: согласия
пожалуйста: пожалуйста
направить: направьте
жалоба: жалобу
заполните: заполните
форма: форме
обратный: обратной
связь: связи
течение: течение
час: часов
закрыть: закроем
доступ: доступ
нелегально: нелегально
разместить: размещенному
контент: контенту
разбить: разбитый
страница: страницу
система: Система
сохранение: сохранения
место: места
последний: последнего
прочитать: прочитанные
позволять: позволяет
с: с
удобство: удобством
необходимость: необходимости
каждый: каждый
раз: Раз
заново: заново
искать: искать
остановиться: остановились
поставить: Поставьте
закладка: Закладка
момент: момент
перейти: перейти
который: которой
закончить: закончили
шрифт: Шрифт
интервал: Интервал
ты: ты
где: где
через: через
десять: десять
минута: минуты
ответить: ответил
он: он
поспешить: поспешил
флаер: флаеру
номер: номере
сразу: сразу
схватить: схвачен
распять: распят
кровать: кровати
после: после
учинить: учинили
форменный: форменный
допрос: допрос
носить: носили
черт: черти
далее: далее
но: но
когда: когда
свет: свет
из: из
рюкзак: рюкзака
извлечь: извлечена
черный: чрная
шкатулка: шкатулка
обида: обиды
мигом: мигом
забыть: забыты
начаться: начались
охи: охи
вздох: вздохи
примерка: Примерка
вращение: вращение
перед: перед
зеркало: зеркалом
все: вс
это: это
один: одного
микроскопический: микроскопических
трусик: трусиках
короче: Короче
закончиться: закончилось
обычно: обычно
постель: постели
день: День
пройти: прошл
там: там
короткий: короткими
перерыв: перерывами
еда: еду
вечер: вечером
затащить: затащен
какойто: какойто
мюзикл: мюзикл
честно: Честно
говорить: говоришь
ничто: Ничего
особенный: особенного
илья: Илье
толком: толком
слушать: слушал
просто: просто
держать: держал
энди: Энди
за: за
рука: рукой
украдкой: украдкой
смотреть: смотрел
нее: не
пока: Пока
поглотить: поглощена
зрелище: зрелищем
разворачиваться: разворачивающимся
подмостки: подмостках
случиться: случиться
неприятный: неприятный
инцидент: инцидент
они: них
возвращаться: возвращались
гостиница: гостиницу
возле: возле
стоянка: стоянки
аэротакси: аэротакси
окружить: окружила
толпа: толпа
молодежь: молодежи
предложить: предложили
поделиться: поделиться
девочка: девочка
также: также
средство: средствами
иметься: имеющимися
личный: личных
счет: счетах
восемь: восемь
человек: человек
одеть: одетых
причудливый: причудливую
светиться: светящуюся
темнота: темноте
одежда: одеждой
ж: ж
такой: такую
подумать: подумал
илюха: Илюха
этот: эти
урод: уроды
тут: тут
ну: Ну
переводиться: переводится
глупость: глупость
человеческий: человеческая
даже: даже
при: при
уровень: уровне
цивилизация: цивилизации
я: я
брать: беру
передний: передних
твой: твои
сзади: сзади
шепнуть: шепнула
два: Два
повторять: повторять
потребоваться: потребуется
добивать: добивал
четверка: четверки
оказаться: оказался
самый: самый
шустрый: шустрый
вооружить: Вооружены
дубинкойэлектрошокер: дубинкойэлектрошокером
подойти: подошедшую
любимый: любимый
помочь: помочь
послышаться: послышался
ворковать: воркующий
голос: голос
справиться: Справлюсь
пропыхтеть: пропыхтел
выбивать: выбивая
нога: ногой
шустрик: шустрика
оружие: оружие
прямой: прямым
челюсть: челюсть
отправлять: отправляя
нокаут: нокаут
чуть: чуть
больше: больше
местный: местный
служба: служба
правопорядок: правопорядка
сработать: сработала
оперативно: оперативно
успеть: успел
еще: ещ
отдышаться: отдышаться
появиться: появился
большой: большой
флаера: флаер
издавать: издающий
резкий: резкий
вой: вой
посыпаться: посыпались
ребята: ребята
заковать: закованные
броня: броню
видеть: видел
пират: пиратов
вести: вл
скоротечный: скоротечный
бой: бой
суук: Сууке
явно: явно
полегче: полегче
менее: менее
смотреться: смотрелась
весьма: весьма
внушительно: внушительно
кавалерия: Кавалерия
спорый: споро
собрать: собрала
раненый: раненых
погрузить: погрузила
следом: следом
карета: карету
скорый: скорой
помощь: помощи
тоже: тоже
естественно: естественно
летучий: летучую
вместе: вместе
проехать: проехать
до: до
прояснение: прояснения
обстоятельство: обстоятельства
виноватый: виновата
больница: больницу
потерпевший: потерпевших
обезьянник: обезьянник
меняться: меняется
лететь: летели
околоток: околоток
объяснить: объясни
выделить: выделить
заархивировать: заархивировать
видеофайл: видеофайл
чтобы: чтобы
предъявить: предъявить
начинать: начинал
проникаться: проникаться
уважение: уважением
нейросеть: нейросетям
чертовскую: чертовскую
удобность: удобность
доказательство: доказательства
уже: уже
готовый: готовы
мурыжили: Мурыжили
недолго: недолго
участок: участок
влететь: влетел
разъяренный: разъяренный
джойло: Джойл
свой: свою
парадный: парадной
да: да
регалия: регалиях
занять: заняв
почти: почти
половина: половину
помещение: помещения
вовсе: вовсе
извиниться: извинившись
отпустить: отпустили
четыре: четыре
сторона: стороны
сказать: скажи
только: только
вскрыться: вскроются
какойлибо: какиелибо
то: то
мочь: мог
вызвать: вызвать
разбирательство: разбирательство
вряд: вряд
ли: ли
кристальный: кристально
ясный: ясно
напасть: напал
получить: получил
эн: Эн
вот: Вот
почему: почему
ни: ни
увольнение: увольнение
проходить: проходит
попытаться: попытался
устроить: устроить
разнос: разнос
сестра: сестру
вечно: вечно
влипать: влипает
неприятность: неприятности
братик: братик
вообще: вообще
настаивать: настаивал
ладно: ладно
сделать: сделала
испуганный: испуганные
глаз: Глаза
заметить: заметила
илио: Илио
вмиг: вмиг
раскидать: раскидал
сопляк: сопляков
поверить: поверил
брат: брат
скромный: поскромнее
спрятаться: спряталась
кустик: кустиках
дрожать: дрожала
страх: страха
рыжий: рыжая
правдивый: правдивы
чистый: чисты
туфля: туфлей
голова: голове
огреть: огрела
максимум: максимум
двое: двоих
правда: Правда
молчать: молчишь
нападаю: нападаю
откровенно: откровенно
забавляться: забавлялся
разговор: разговором
уж: уж
онто: онто
помнить: помнил
мелькать: мелькали
красивый: красивые
длинный: длинные
стройный: стройные
ножка: ножки
другой: другим
опешить: опешивших
молодчик: молодчиков
бессознательный: бессознательное
состояние: состояние
нууа: Нууу
бы: бы
хоть: хоть
одеваться: одеваться
пытаться: пытался
увещевать: увещевать
посмотреть: посмотри
показать: показал
палец: пальцем
платье: платье
больший: большим
декольте: декольте
полностью: полностью
открыть: открытой
спина: спиной
юбка: юбкой
подол: подол
скрыть: скрыть
восхитительный: восхитительные
ягодица: ягодицы
голый: голая
ничего: Ничего
понимать: понимаешь
современный: современной
мода: моде
мужлан: мужлан
захихикать: захихикала
бестия: бестия
потом: потом
разве: разве
тело: тело
можно: можно
под: под
чертовка: чертовка
принять: приняла
соблазнительный: соблазнительную
поза: позу
плюнуть: плюнул
досада: досады
махнуть: махнув
покинуть: покинул
влюбить: влюблнную
парочка: парочку
представлять: Представляем
внимание: вниманию
похожий: похожие
отобрать: отобрали
схожий: схожую
название: названию
смысл: смысле
литература: литературу
надежда: надежде
предоставить: предоставить
читатель: читателей
вариант: вариантов
интересный: интересные
обсуждение: Обсуждение
собственный: собственные
мнение: мнения
оставить: Оставьте
думать: думаете
главный: главных
указать: Укажите
конкретно: конкретно
понравиться: понравилось
нет: нет
считать: считаете
