заголовок: Заголовок
олег: Олег
данильченко: Данильченко
имперский: Имперский
вояж: вояж
читать: читать
онлайн: онлайн
бесплатно: бесплатно
адрес: Адрес
здесь: Здесь
быть: Будь
возможность: Возможность
весь: всм
текст: текст
электронный: электронной
книга: книге
совершенно: совершенно
целиком: целиком
полный: полную
версия: версию
в: в
некоторый: некоторых
случай: случаях
присутствовать: присутствует
краткий: краткое
содержание: содержание
город: Город
м: М
спб: СПб
год: год
выпуск: выпуска
издательство: издательство
аста: АСТ
издательский: Издательский
дом: дом
ленинград: Ленинград
категория: категорию
боевой: боевое
фантастика: фантастика
космический: Космическая
на: на
русский: русским
язык: языке
описание: описание
произведение: произведении
предисловие: предисловие
а: а
так: так
же: же
отзыв: отзывы
посетитель: посетителей
доступный: доступны
портал: портале
библиотека: Библиотека
либ: Либ
кат: Кат
создать: создана
для: для
любитель: любителей
полистать: полистать
хороший: хорошее
книжка: книжку
и: и
предлагать: Предлагаем
широкий: широкий
выбор: выбора
жанр: жанров
любовный: любовные
роман: романы
фэнтези: фэнтези
приключение: приключения
детектив: детективы
триллер: триллеры
эротика: эротика
документальный: документальные
научный: научные
юмористический: юмористические
анекдот: анекдоты
о: о
бизнес: бизнесе
проза: проза
детский: детские
сказка: сказки
религиия: религиии
новинка: новинки
православный: православные
старинный: старинные
про: про
компьютер: компьютеры
программирование: программирование
английский: английском
домоводство: домоводство
поэзия: поэзия
выбрав: Выбрав
по: по
душа: душе
вы: Вы
смочь: сможете
найти: Нашл
действительно: действительно
стоить: стоящие
насладиться: насладиться
погружение: погружением
мир: мир
воображение: воображения
прочувствовать: прочувствовать
переживание: переживания
герой: героях
или: или
узнать: Узнайте
себя: себе
чтото: чтото
новый: новые
совершить: совершить
внутренний: внутреннее
открытие: открытие
подробный: Подробная
информация: информацию
ознакомление: ознакомления
текущий: текущему
запрос: запросу
представить: представлен
низкий: Ниже
к: к
чтение: чтение
аннотация: аннотацию
зависеть: зависит
от: От
тот: то
что: что
написать: напишите
сам: сам
автор: автора
если: Если
не: не
необходимый: необходимо
комментарий: комментарии
мы: Мы
постараться: постараемся
отыскать: отыскать
она: она
кто: Кого
фамилия: фамилию
как: Как
звать: зовут
список: списком
его: его
серия: сериям
уважаемые: Уважаемые
правообладатель: правообладатели
размещать: размещать
наш: нашем
сайт: сайте
у: у
любой: любых
зарегистрировать: зарегистрированного
пользователь: пользователя
ваш: ваши
опубликовать: опубликована
без: без
согласие: согласия
пожалуйста: пожалуйста
направить: направьте
жалоба: жалобу
заполните: заполните
форма: форму
обратный: обратной
связь: связи
течение: течение
час: часов
закрыть: закроем
доступ: доступ
нелегально: нелегально
разместить: размещенному
контент: контенту
разбить: разбитый
страница: страницу
система: Система
сохранение: сохранения
место: места
последний: последней
прочитать: прочитанные
позволять: позволяет
с: с
удобство: удобством
необходимость: необходимости
каждый: каждый
раз: раз
заново: заново
искать: искать
остановиться: остановились
поставить: Поставьте
закладка: Закладка
момент: момент
перейти: перейти
который: которая
закончить: закончили
шрифт: Шрифт
интервал: Интервал
угу: Угу
рассказать: рассказать
чтонибудь: чтонибудь
свой: свою
планета: планету
давать: Давайте
рассказывать: рассказывал
это: это
ну: ну
вот: вот
например: например
илюха: Илюха
минута: минуту
задуматься: задумался
бы: бы
такой: такого
чтоб: чтоб
понятный: понятна
многий: Многие
только: только
потом: потом
вспомнить: вспомнил
один: одна
слышать: слышал
край: краем
ухо: уха
разговор: разговор
зевран: Зевран
черим: Черимом
бал: Балах
жаловаться: жаловался
мама: маму
жена: жены
мол: мол
уже: уже
совсем: совсем
достать: достала
похоже: Похоже
этот: этой
тема: тема
начать: Начал
он: ему
хоронить: хоронит
мужик: мужик
теща: тща
второй: вторая
спрашивать: спрашивает
слушать: Слушай
вдруг: вдруг
твой: твоя
помереть: померла
гриб: грибами
отравиться: отравилась
отвечать: отвечает
почему: почему
тогда: тогда
лицо: лица
синий: синее
зараза: зараза
их: их
хотеть: хотела
риго: Риго
заржать: заржал
поперхнувшись: поперхнувшись
сок: соком
вторить: вторила
заливаясь: заливаясь
беррана: Беррана
звонкий: звонкий
смех: смех
энци: Энци
довершать: довершал
звуковой: звуковую
симфония: симфонию
всеобщий: всеобщего
веселие: веселья
за: за
стол: стола
еще: ещ
потребовать: потребовали
голос: голос
ребята: ребят
нет: нет
проблема: проблем
илья: Илья
травить: травил
иногда: иногда
слегка: слегка
адаптировать: адаптируя
под: под
местный: местную
реалия: реалии
пойти: пошли
ура: ура
подтягиваться: подтягиваться
народ: народ
соседний: соседнем
столик: столиков
через: Через
полчаса: полчаса
порядочный: порядочно
хохотать: хохотало
вокруг: вокруг
землянин: Землянин
мочь: может
долго: долго
развлекать: развлекать
аудитория: аудиторию
но: Но
пора: пор
выдвигаться: выдвигаться
арсенал: арсенал
главный: главных
добиться: добился
напряжение: Напряжение
снять: снято
настроение: настроение
заодно: заодно
получить: получил
расположение: расположение
параллельный: параллельного
поток: потока
технарь: технарей
ладно: ладно
сегодня: сегодня
уууууууа: Уууууууу
разочарованно: разочарованно
загудеть: загудел
собраться: собравшийся
команда: команда
правда: правда
зачет: зачты
поди: поди
заждаться: заждались
удача: Удачи
дать: Дайте
там: там
следовать: следует
посыпаться: посыпались
они: они
вслед: вслед
напутствие: напутствия
ответить: ответил
направляться: направляясь
потянуться: потянулась
глава: Глава
волнение: волнения
пробегать: пробегая
перед: перед
глаз: глаза
наверное: наверное
сотый: сотый
где: где
носить: носит
да: Да
ты: ты
мельтешить: мельтеши
старый: старый
прийти: Придт
никуда: никуда
деться: денется
время: времени
тут: Тут
дверь: дверь
открыться: открылась
порог: пороге
появиться: появился
можно: Можно
заходить: Заходи
сорваться: сорвался
ходить: ходишь
столовая: столовой
отравить: отравил
понять: понял
разный: разные
смешной: смешно
история: истории
объяснить: объяснила
из: из
близняшка: близняшек
ой: Ой
до: до
сей: сих
живот: живот
болеть: болит
добавить: добавила
буркнуть: буркнул
дед: дед
переглянувшись: переглянувшись
многозначительный: многозначительно
ответ: ответ
одобрительно: одобрительно
прикрыть: прикрыл
решить: решил
выбрать: выбрать
экипировка: экипировки
брать: Берем
легкий: лгкую
броня: броня
стрелковка: стрелковку
минимум: минимуму
остальной: остальное
добрать: доберм
взрывчатка: взрывчаткой
мина: минами
заявление: заявления
вытянуться: вытянулись
старпер: старпры
довольно: довольно
заулыбались: заулыбались
я: я
ж: ж
говорить: говорил
скрипнуть: скрипнул
будто: будто
спорить: спорил
ребятки: ребятки
обрез: обрез
быстро: Быстро
собираться: собираемся
одеваться: одеваемся
бег: бегом
полигон: полигон
идемте: Идмте
взять: взял
инициатива: инициативу
рука: руки
трое: троим
ход: ходу
иметь: имею
вид: виду
берран: Беррану
лео: Лео
подойти: подойдет
стандартный: стандартная
выбирать: выбирайте
показать: показал
разложить: разложенные
стеллаж: стеллаже
готовый: готовые
использование: использованию
комплект: комплекта
дочка: дочки
повернуться: повернулся
близнец: близнецам
ночь: ночь
работать: работал
уж: Уж
больно: больно
росточком: росточком
подкачать: подкачали
ничто: ничего
слава: слава
елазня: Елазне
ум: ума
выжить: выжил
коечто: коечто
владейте: Владейте
лежать: лежали
два: два
поблескивать: поблескивая
свежий: свежей
краска: краской
лак: лаком
ух: Ух
восхищенный: восхищенно
пискнуть: пискнули
блонда: блонды
красивый: Красивые
какой: какие
спасибо: спасибо
дедушка: дедушка
зев: Зева
растроганно: растроганно
мой: моя
работа: работы
видно: видно
приятный: приятно
помочь: помогу
одеться: одеться
отдельно: Отдельно
нужный: нужное
сказать: сказать
скафандр: скафандров
содружество: Содружества
девайс: девайсы
универсальный: универсальны
использоваться: использоваться
условие: условиях
открытый: открытый
космос: космос
наземный: наземные
операция: операции
подводный: подводные
первый: Первую
скрипка: скрипку
дело: деле
играть: играл
специальный: специальной
комбез: комбез
обтягивать: обтягивающий
тело: тело
обеспечивать: обеспечивающий
мера: мере
давление: давление
встроить: встроенным
экзоскелет: экзоскелетом
комбинезон: комбинезон
являться: являлся
суть: сути
современный: современных
земной: земных
аналог: аналогах
внутри: внутри
пустотный: пустотных
создаваться: создается
путь: путм
нагнетание: нагнетания
воздух: воздуха
создавать: создает
устройство: устройствах
счет: счт
плотный: плотного
обжатие: обжатия
ткань: тканью
менять: менять
облегать: облегая
настолько: настолько
плотно: плотно
насколько: насколько
данный: данный
сталкиваться: сталкивался
особенность: особенностью
когда: когда
непобедимый: Непобедимом
впервые: впервые
надевать: надевал
повседневный: повседневную
представлять: Представляем
внимание: вниманию
похожий: похожие
отобрать: отобрали
схожий: схожую
название: названию
смысл: смысле
литература: литературу
надежда: надежде
предоставить: предоставить
читатель: читателей
больше: больше
вариант: вариантов
интересный: интересные
обсуждение: Обсуждение
просто: просто
собственный: собственные
мнение: мнения
оставить: Оставьте
думать: думаете
указать: Укажите
конкретно: конкретно
понравиться: понравилось
считать: считаете
