заголовок: Заголовок
олег: Олег
данильченко: Данильченко
имперский: Имперский
вояж: вояж
читать: читать
онлайн: онлайн
бесплатно: бесплатно
адрес: Адрес
здесь: Здесь
быть: был
возможность: возможность
весь: Вс
текст: текст
электронный: электронной
книга: книге
совершенно: совершенно
целиком: целиком
полный: полную
версия: версию
в: в
некоторый: некоторых
случай: случае
присутствовать: присутствует
краткий: краткое
содержание: содержание
город: Город
м: М
спб: СПб
год: год
выпуск: выпуска
издательство: издательство
аста: АСТ
издательский: Издательский
дом: дома
ленинград: Ленинград
категория: категорию
боевой: Боевая
фантастика: фантастика
космический: Космическая
на: на
русский: русском
язык: языке
описание: описание
произведение: произведении
предисловие: предисловие
а: а
так: так
же: же
отзыв: отзывы
посетитель: посетителей
доступный: доступны
портал: портале
библиотека: Библиотека
либ: Либ
кат: Кат
создать: создана
для: для
любитель: любителей
полистать: полистать
хороший: хорошую
книжка: книжку
и: и
предлагать: Предлагаем
широкий: широкий
выбор: выбора
жанр: жанров
любовный: любовные
роман: романы
фэнтези: фэнтези
приключение: приключения
детектив: детективы
триллер: триллеры
эротика: эротика
документальный: документальные
научный: научные
юмористический: юмористические
анекдот: анекдоты
о: о
бизнес: бизнесе
проза: проза
детский: детские
сказка: сказки
религиия: религиии
новинка: новинки
православный: православные
старинный: старинные
про: про
компьютер: компьютеры
программирование: программирование
английский: английском
домоводство: домоводство
поэзия: поэзия
выбрав: Выбрав
по: по
душа: душе
вы: Вы
смочь: сможете
найти: нашли
действительно: действительно
стоить: стоящие
насладиться: насладиться
погружение: погружением
мир: мир
воображение: воображения
прочувствовать: прочувствовать
переживание: переживания
герой: героях
или: или
узнать: Узнайте
себя: себя
чтото: чтото
новый: новые
совершить: совершил
внутренний: внутреннее
открытие: открытие
подробный: Подробная
информация: информацию
ознакомление: ознакомления
текущий: текущему
запрос: запросу
представить: представлен
низкий: Ниже
к: к
чтение: чтение
аннотация: аннотацию
зависеть: зависит
от: от
тот: той
что: что
написать: напишите
сам: сам
автор: автора
если: если
не: не
необходимый: необходимую
комментарий: комментарии
мы: Мы
постараться: постараемся
отыскать: отыскать
она: она
кто: Кто
фамилия: фамилию
как: как
звать: зовут
список: списком
его: его
серия: сериям
уважаемые: Уважаемые
правообладатель: правообладатели
размещать: размещать
наш: нашем
сайт: сайте
у: у
любой: любой
зарегистрировать: зарегистрированного
пользователь: пользователя
ваш: ваши
опубликовать: опубликована
без: без
согласие: согласия
пожалуйста: пожалуйста
направить: направьте
жалоба: жалобу
заполните: заполните
форма: форму
обратный: обратной
связь: связи
течение: течение
час: часов
закрыть: закроем
доступ: доступ
нелегально: нелегально
разместить: размещенному
контент: контенту
разбить: разбитых
страница: страницу
система: Система
сохранение: сохранения
место: места
последний: последней
прочитать: прочитанные
позволять: позволяет
с: с
удобство: удобством
необходимость: необходимости
каждый: Каждый
раз: раз
заново: заново
искать: искать
остановиться: остановились
поставить: Поставьте
закладка: Закладка
момент: момент
перейти: перейти
который: который
закончить: закончили
шрифт: Шрифт
интервал: Интервал
дрейфить: дрейфь
сержант: сержант
еще: ещ
покочевряжиться: покочевряжимся
слышаться: слышится
спокойный: спокойный
голос: голос
илья: Илья
дрейфит: дрейфит
такой: такая
ситуация: ситуациях
страх: Страх
нет: нет
адреналин: адреналин
только: только
из: из
ухо: ушей
хлестать: хлещет
отходняк: отходняк
откат: откат
называть: называйте
хотеть: хотите
приходить: приходит
потом: потом
пока: пока
просто: просто
до: до
это: это
время: времени
осмысливать: осмысливать
положение: положение
они: они
угодить: угодили
надо: Надо
стрелять: стреляет
вот: вот
очередной: очередной
выглянуть: выглянув
оконный: оконный
проем: проем
поиск: поиска
цель: цели
он: Он
замечать: замечает
изза: изза
угол: угол
напротив: напротив
выскакивать: выскакивает
человек: человек
ручной: ручным
гранатомет: гранатометом
резко: резко
падать: падает
один: одного
колено: колени
жать: жмт
спусковой: спусковой
крючок: крючок
гранатометчик: гранатометчика
отбрасывать: отбрасывает
назад: назад
изломанный: изломанной
кукла: куклой
но: но
граната: граната
уже: уже
пойти: пошла
гранат: Граната
бояться: БОЙСЯ
успевать: успевает
крикнуть: крикнуть
рыбка: рыбкой
бросаться: бросается
за: за
укрытие: укрытие
пытаться: пытается
уйти: уйти
зона: зоны
поражение: поражения
почти: ПОЧТИ
успеть: успел
считаться: считается
горячий: Горячая
тугой: тугая
взрывной: взрывная
волна: волна
подхватывать: подхватывает
смачно: смачно
припечатывать: припечатывает
стена: стены
собираться: собирался
укрыться: укрыться
свет: Свет
меркнуть: меркнет
кадр: Кадр
меняться: меняется
теперь: Теперь
четырнадцать: четырнадцать
выжить: выживших
стоять: стоят
илюха: Илюха
пятнадцатый: пятнадцатый
связать: свяжут
сзади: сзади
рука: Руки
чувствоваться: чувствуются
видать: видать
давно: давно
очнуться: очнулся
верный: вернее
правильнее: правильнее
сказать: сказать
очнуль: очнули
пинок: пинка
сбросить: сбросив
кузов: кузова
шишига: шишиги
сознание: сознание
прийти: пришедший
соприкосновение: соприкосновения
лицо: лице
каменистый: каменистой
почва: почвой
застонав: Застонав
попытаться: попытался
подняться: подняться
дать: дали
шанс: шанса
чейто: Чьято
сильный: сильная
схватить: схватив
шиворот: шиворот
дергать: дргают
вверх: вверх
толчок: толчок
спина: спину
ничто: ничего
соображать: соображая
снова: снова
лететь: летит
день: день
таки: таки
удаваться: Удатся
извернуться: извернуться
полет: полту
чтобы: чтобы
хряснутиться: хряснуться
морда: мордой
этот: этого
часть: части
организм: Организм
удаться: удалось
сберечь: сберечь
камень: камни
упасть: упал
бок: боком
маленький: маленькой
победа: победой
противный: Противный
хруст: хруст
дикий: дикая
боль: Болью
два: две
сломать: сломан
ребро: рбра
результат: результат
акробатический: акробатического
дебют: дебюта
ан: Ан
хохот: хохот
похоже: похоже
ктото: комуто
прийтись: пришлись
кульбит: кульбиты
хватать: хватают
шкирка: шкирку
волочь: волокут
трещать: трещат
нитка: нитки
пуговица: пуговицы
шрапнель: шрапнелью
разлетаться: разлетаются
куртка: куртка
бы: бы
слететь: слетела
вслед: вслед
да: да
сняться: снимется
продолжать: продолжают
кудато: кудато
тащить: тащила
опять: опять
сохранить: сохранить
целостность: целостность
район: районе
очень: очень
глаз: глаза
начинать: начинают
заплывать: заплывать
всетаки: всетаки
знатно: знатно
законнектиться: законнектился
планета: планетой
почемуто: Почемуто
вспоминаться: вспоминается
капитан: капитана
поделиться: поделился
патрон: патронами
всего: всего
подбить: подбит
тут: тут
счастие: счастье
сразу: сразу
блин: блин
нос: нос
наконец: Наконец
путешествие: путешествие
метод: методом
грубый: грубого
волочение: волочения
достигать: достигает
финиш: финиша
приготовиться: приготовился
следующий: следующему
однако: однако
побывать: побывать
шкура: шкуре
пернатый: пернатого
когда: Когда
практически: практически
принять: принять
вертикальный: вертикальное
удар: удар
под: под
нога: ноги
подгибаться: подгибаются
самый: самые
острый: острые
пробовать: пробует
прочность: прочность
оказываться: оказываются
намного: намного
прочнее: прочнее
вцепляться: вцепляется
подбородок: подбородок
задирать: задирая
открыть: открыть
открываться: открывались
мало: мало
измениться: изменилось
добиться: добиться
узенький: узенькие
щелочка: щлочки
прогресс: прогресс
хоть: хоть
можно: можно
рассмотреть: рассмотреть
свой: своего
мучитель: мучителя
посмотреть: посмотреть
здоровенный: Здоровенный
детина: детина
американский: американском
камуфляж: камуфляже
зарасти: заросший
черный: чрной
бородища: бородищей
хотя: хотя
поход: походу
борода: борода
начинаться: начинается
бровь: бровей
мочь: могут
вообще: вообще
промежуток: промежутка
между: между
растительность: растительностью
череп: черепе
поди: Поди
разобраться: разберись
ведь: ведь
сверху: сверху
бандан: бандана
лоб: лба
видно: видно
интересный: интересные
подумать: подумал
густой: густые
ресница: ресницы
подуматьто: Подумалто
вслух: вслух
улыбнуться: улыбнулся
непроизвольно: непроизвольно
угадать: угадал
гримаса: гримасе
губа: губ
улыбка: улыбку
весьма: весьма
сложный: сложно
мордоворот: мордоворот
экстрасенс: Экстрасенс
мать: мать
скалиться: Скалишься
падаль: падаль
участливый: Участливо
ощериться: ощерилось
гнилой: гнилыми
зуб: зубами
чудо: чудо
природа: природы
оно: Оно
разговаривать: разговаривает
бам: БАМ
кулак: кулак
громила: громилы
короткий: короткое
движение: движение
закончиться: закончилось
многострадальный: многострадальной
верхний: верхней
занавес: Занавес
везде: везде
вздох: вздох
нож: нож
голова: голова
словно: словно
семенной: семенной
огурец: огурец
вотвот: вотвот
взорваться: взорвтся
давление: давления
изнутри: изнутри
данный: данном
семя: семенами
мозг: мозгами
опухнуть: Опухшие
также: также
напоминать: напоминают
хозяин: хозяину
подходящий: подходящая
опора: опора
преминуть: преминули
поведать: поведать
то: то
отвалиться: отвалиться
ненароком: ненароком
ну: Ну
жажда: ЖАЖДА
куча: кучи
пить: Пить
хотеться: хотелось
казаться: казалось
выхлебать: выхлебал
озеро: озеро
байкал: Байкал
пара: пару
глоток: глотка
наверно: наверно
хватить: хватит
пошевелиться: пошевелиться
ага: ага
щазза: щазз
против: против
стрельнуть: стрельнуло
аж: аж
слеза: слезы
вышибить: вышибло
застонать: застонал
представлять: Представляем
внимание: вниманию
похожий: похожие
отобрать: отобрали
схожий: схожую
название: названию
смысл: смысле
литература: литературу
надежда: надежде
предоставить: предоставить
читатель: читателей
больше: больше
вариант: вариантов
обсуждение: Обсуждение
собственный: собственные
мнение: мнения
оставить: Оставьте
думать: думаете
главный: главных
указать: Укажите
конкретно: конкретно
понравиться: понравилось
почему: почему
считать: считаете
