заголовок: Заголовок
олег: Олег
данильченко: Данильченко
имперский: Имперский
вояж: вояж
читать: читать
онлайн: онлайн
бесплатно: бесплатно
адрес: Адрес
здесь: Здесь
быть: будем
возможность: Возможность
весь: все
текст: текст
электронный: электронной
книга: книге
совершенно: совершенно
целиком: целиком
полный: Полный
версия: версию
в: в
некоторый: некоторых
случай: случаях
присутствовать: присутствует
краткий: краткое
содержание: содержание
город: Город
м: М
спб: СПб
год: год
выпуск: выпуска
издательство: издательство
аста: АСТ
издательский: Издательский
дом: дом
ленинград: Ленинград
категория: категорию
боевой: Боевая
фантастика: фантастика
космический: Космическая
на: на
русский: русском
язык: языке
описание: описание
произведение: произведении
предисловие: предисловие
а: а
так: так
же: же
отзыв: отзывы
посетитель: посетителей
доступный: доступны
портал: портале
библиотека: Библиотека
либ: Либ
кат: Кат
создать: создана
для: для
любитель: любителей
полистать: полистать
хороший: Хорошо
книжка: книжку
и: и
предлагать: Предлагаем
широкий: широкий
выбор: выбора
жанр: жанров
любовный: любовные
роман: романы
фэнтези: фэнтези
приключение: приключения
детектив: детективы
триллер: триллеры
эротика: эротика
документальный: документальные
научный: научные
юмористический: юмористические
анекдот: анекдоты
о: о
бизнес: бизнесе
проза: проза
детский: детские
сказка: сказки
религиия: религиии
новинка: новинки
православный: православные
старинный: старинные
про: Про
компьютер: компьютеры
программирование: программирование
английский: английском
домоводство: домоводство
поэзия: поэзия
выбрав: Выбрав
по: по
душа: души
вы: Вы
смочь: сможете
найти: нашли
действительно: действительно
стоить: стоящие
насладиться: насладиться
погружение: погружением
мир: миром
воображение: воображения
прочувствовать: прочувствовать
переживание: переживания
герой: героях
или: или
узнать: Узнайте
себя: себе
чтото: чтото
новый: новые
совершить: совершить
внутренний: внутреннее
открытие: открытие
подробный: Подробная
информация: информации
ознакомление: ознакомления
текущий: текущему
запрос: запросу
представить: представлен
низкий: Ниже
к: к
чтение: чтение
аннотация: аннотацию
зависеть: зависит
от: от
тот: Та
что: что
написать: напишите
сам: сами
автор: автора
если: Если
не: не
необходимый: необходимую
комментарий: комментарии
мы: Мы
постараться: постараемся
отыскать: отыскать
она: е
кто: Кто
фамилия: фамилию
как: как
звать: зовут
список: списком
его: его
серия: сериям
уважаемые: Уважаемые
правообладатель: правообладатели
размещать: размещать
наш: нашем
сайт: сайте
у: у
любой: любой
зарегистрировать: зарегистрированного
пользователь: пользователя
ваш: ваши
опубликовать: опубликована
без: без
согласие: согласия
пожалуйста: пожалуйста
направить: направьте
жалоба: жалобу
заполните: заполните
форма: форму
обратный: обратной
связь: связей
течение: течение
час: часов
закрыть: закроем
доступ: доступ
нелегально: нелегально
разместить: размещенному
контент: контенту
разбить: разбитый
страница: страницу
система: Система
сохранение: сохранения
место: места
последний: Последнее
прочитать: прочитанные
позволять: позволяет
с: с
удобство: удобством
необходимость: необходимости
каждый: каждый
раз: раз
заново: заново
искать: искать
остановиться: остановились
поставить: Поставьте
закладка: Закладка
момент: момент
перейти: перейти
который: которую
закончить: закончили
шрифт: Шрифт
интервал: Интервал
нет: нет
только: только
поступить: поступил
ты: тебя
судить: судя
это: это
илья: Илья
показать: показал
взгляд: взглядом
гопкомпания: гопкомпанию
покидать: покидающую
столовая: столовую
откуда: откуда
знать: знаю
он: его
земляк: земляки
вроде: вроде
я: Я
тоже: тоже
сигур: Сигура
семейство: семейство
пилс: Пилса
особенно: особенно
папаша: папаша
слух: слухи
ходить: ходят
фактовто: фактовто
пират: пиратами
новость: новостях
появляться: появляется
то: то
известный: известный
политик: политик
зато: Зато
пил: Пиле
уже: уже
глаз: глаза
намозолить: намозолил
свой: свой
выходка: выходками
отморозок: отморозок
рудный: рудных
шахта: шахтах
но: но
нем: нм
чает: чает
прикрывать: Прикрывает
постоянно: постоянно
когда: когда
собираться: собирался
сюда: сюда
учеба: учебу
думать: думаете
большой: больше
увидеть: увижу
рожа: рожу
этот: этот
придурок: придурка
видеть: видишь
выйти: вышло
буквально: Буквально
за: за
неделя: недели
до: до
мой: моим
отлет: отлета
очередной: очередной
прославиться: прославился
изнасиловать: Изнасиловал
потом: потом
убить: убил
дочь: дочь
верховный: верховного
судья: судье
такой: такое
резонанс: резонанс
скрыть: скрыть
сложный: сложно
сми: СМИ
трещать: трещали
однако: Однако
можно: можно
заткнуть: Заткнули
рот: рот
средство: средствам
массовый: массовой
папик: папик
похоже: похоже
сослать: сослал
видимо: видимо
наказание: наказания
мд: Мд
вздохнуть: вздохнул
интересный: интересные
фрукт: фрукт
вот: Вот
свезти: свезло
свезло: свезло
дать: Дал
бог: бог
сокурсник: сокурсника
какой: какую
направление: направление
выбрать: выбрал
слышать: Слышал
както: както
край: краем
ухо: уха
пилот: пилотов
собраться: собрался
прийтись: Придтся
часто: часто
видеться: видеться
чтоб: чтоб
бездна: бездна
забрать: забрала
да: да
ладно: ладно
грузиться: грузись
подмигнуть: подмигнул
илюха: Илюха
прорваться: прорвмся
надо: надо
приглядывать: приглядывать
дерьмо: дерьмом
пара: пара
мысль: мыслей
отбить: отбить
охота: охоту
хулиганить: хулиганить
сначала: сначала
поглядеть: поглядим
делать: делать
ведь: ведь
вместе: вместе
учиться: учимся
ну: ну
знакомый: знакомы
протянуть: протянул
рука: руки
риго: Риго
крепко: крепко
пожать: пожал
поразиться: поразился
пропасть: пропасть
между: между
даже: даже
жест: жесте
похожий: похожие
удивительно: Удивительно
черт: чрт
взять: возьми
вслух: вслух
продолжить: продолжил
сказать: сказал
учебато: учебато
начаться: начнтся
выглядеть: выглядит
завтра: завтра
группа: Группа
набрать: набрана
технарь: Технари
комплект: комплекте
построение: построение
утро: утра
принять: примем
присяга: присяга
вперед: вперд
знание: знаниям
погодитька: Погодика
еще: ещ
давать: Давай
поподробнее: поподробнее
один: одну
принимать: принимают
назад: назад
удивиться: удивился
норк: Норк
значить: Значит
верность: верность
империя: Империи
естественно: естественно
аааа: Аааа
из: из
смысл: смысле
понять: понял
вопрос: вопроса
дикий: диких
повторить: повторил
смутиться: смутился
улыбнуться: улыбнулся
ага: Ага
они: Они
смущаться: смущайся
привыкнуть: привык
время: время
называть: называют
нормальный: нормально
подумать: подумай
плохой: плохого
разница: разницы
просто: просто
непривычно: непривычно
впервые: впервые
встречать: встречаю
человек: человека
родиться: родившегося
содружество: Содружестве
рассказать: Расскажешь
какнибудь: какнибудь
реально: реально
устать: устал
понимать: Понимаю
поднять: Поднял
извиняться: извиняющемся
проблема: проблем
кстати: кстати
куда: куда
определить: определили
проживание: проживание
сектор: секторе
б: Б
каюта: каюта
триста: триста
десять: десять
ух: Ух
ж: ж
сосед: соседи
хоть: хоть
компания: компанией
другой: другом
поселиться: поселился
вообще: вообще
бы: бы
житья: житья
ребятки: ребятки
вокруг: вокруг
гуртоваться: гуртуются
местный: местные
прихвостень: прихвостни
прибыть: Прибыли
два: две
надеяться: надеялся
гденибудь: гденибудь
поверхность: поверхность
метрополия: Метрополии
обретаться: обретаться
податься: подался
тут: Тут
народ: народу
хватать: хватало
деньга: деньгами
туго: туго
идти: идут
жить: жить
где: где
питание: питание
труд: труда
удаться: удалось
свита: свиту
собрать: собрать
развлекаться: развлекаются
поехать: поедут
вернуться: вернутся
понятно: Понятно
проще: проще
приземлить: приземлить
остальной: остальные
разбежаться: разбегутся
испугаться: испугался
вздумать: вздумай
суд: судам
затаскать: затаскают
дрейфить: дрейфь
братуха: братуха
хлопнуть: хлопнул
плечо: плечу
трогать: трогать
тогда: тогда
посмотреть: посмотрим
главный: главных
ссать: ссы
пучок: пучком
там: там
простой: просто
обычный: обычная
эмигрант: эмигрантов
ее: е
соискатель: соискатели
гражданство: гражданство
получить: получим
право: праву
рождение: рождения
через: через
проходить: проходил
военный: военными
счет: счет
армия: армию
сразу: сразу
приниматься: приниматься
действовать: действующие
звание: звания
флот: флота
далее: далее
числиться: числиться
резервист: резервистами
спасибо: спасибо
объяснение: объяснение
поблагодарить: поблагодарил
пояс: поясе
оружие: Оружие
представлять: Представляем
внимание: вниманию
отобрать: отобрали
схожий: схожую
название: названию
литература: литературу
надежда: надежде
предоставить: предоставить
читатель: читателей
больше: больше
вариант: вариантов
обсуждение: Обсуждение
собственный: собственные
мнение: мнения
оставить: Оставьте
указать: Укажите
конкретно: конкретно
понравиться: понравилось
почему: почему
считать: считаете
